babton = n. pepper (capsicum)
bach = v. shoot
bach = n. shot
bachHa' = v. err, make a mistake
bachlu'meH chuq = n. effective range
bagh = v. tie
baghHa' = v. crack a code
baghneQ = n. spoon
baH = v. fire (torpedo, rocket, missile)
baHjan = n. launcher
baHwI' = n. gunner
baj = v. earn, work for (actively)
bal = n. jug, jar, bottle
bam = v. face (have the prospect of having to deal with)
ban = v. be bruised
banmoH = v. bruise
bang = n. love, one who is loved
bang bom = n. love song
bang pong = n. pet name, endearment
baq = v. terminate, discontinue
baqghol = n. type of liquor, bahgol
baQ = v. toss bat'leth from one hand to the other
baQ = v. be fresh, be just picked (fruit, vegetable)
baQ = v. take turns
bar = v. blink, flash
barwI' = n. {wavre':n}
bargh = n. flat-bottomed pot for food preparation
barot = n. Barot
baS Ha'on = n. {Ha'on:n}
baS laSvargh = n. foundry
baS SIrgh = n. wire
baS 'In = n. metal drum, bell
batlh bIHeghjaj. = May you die well.
batlh Daqawlu'taH. = You will be remembered with honor.
batlh ghob yIpab. = Adhere to virtue honorably.
batlh Heghlu'chugh noDnISbe' vay'. = An honorable death requires no vengeance.
batlh malja' DaHuq. = You transact business honorably.
batlh potlh law' yIn potlh puS. = Honor is more important than life.
batlh qelDI' tlhIngan, lumbe'. = A Klingon does not postpone a matter of honor.
batlh tlhIngan Segh yIHub. = Defend the Klingon race with honor.
batlhHa' vanglu'taHvIS quv chavbe'lu'. = One does not achieve honor while acting dishonorably.
bav = v. orbit
baw' = v. be comfortable, be feeling prepared, be confident
baw'Ha' = v. be uncomfortable, be worried, be hesitant
bay'eS = n. inferior, subordinate
ba' = v. sit
beb mutlhwI' = n. roofer, roof layer
bech = v. suffer
begh = n. deflectors
begh botjan = n. deflector shield(s)
begh DaH = n. deflector array
bej = v. watch
bej = v. be sure, be definite, be positive, be certain
bel = v. be pleased
bel = n. pleasure
belHa' = v. be displeased
belHa'moH = v. displease, disappoint
bel Qu' = n. hobby
bem = n. sole of foot
ben = n. years ago
ben = n. years old
bep = v. complain, object, gripe
beq = n. crew, crewman
beq pa'mey = n. non-commissioned crew quarters
beqpuj = n. type of mineral, bekpuj (orange in color)
beQ = v. be flat
ber = v. ovulate, undergo ovulation
bergh = v. be irritable
berghmoH = v. irritate
bertlham taymey = n. epilogue
bertlham 'echlet = n. back cover (of book)
bet = v. impale
betleH = n. type of hand weapon, bat'leth
betleH bey' = n. bat'leth display
betleH 'obe' = n. Order of the Bat'leth
bewSom pa' = n. brewery (room)
bewSom qach = n. brewery (building)
beyHom bey bey'a' jachtaH = to roar in crescendo
beylana = n. B'Elanna
bey' = n. ceremonial display
be' = n. female, woman
be'etor = n. B'Etor
be'Hom = n. girl
be'nal = n. wife
be'nI' = n. sister
be'taSeD = n. Betazed
bI- = v. you-none
bIDIlbe'chugh vaj bIHegh! = Pay or die!
bIH = n. they, them (incapable of language)
bIHeghvIpchugh bIHeghpu'. = If you are afraid to die, you have already died.
bIj = v. punish
bIjatlhHa'chugh qaHoH. = If you say the wrong thing, I will kill you.
bIjatlh 'e' yImev! = Shut up!
bIjatlh 'e' yImev. yItlhutlh! = Stop talking! Drink!
bIjeghbe'chugh vaj bIHegh! = Surrender or die!
bIje'be'chugh vaj bIHegh! = Buy or die!
bIleSnIS. = You need a rest.
bIlugh. = You are right.
bIlughbe'. = You are wrong.
bIlujlaHbe'chugh bIQaplaHbe'. = If you cannot fail, you cannot succeed.
bImejDI' reH betleHlIj yItlhap. = Never leave without your bat'leth.
bImoHqu'. = You're very ugly.
bInajtaHvIS qeylIS Daghomjaj. = May you encounter Kahless in your dreams.
bIng = n. area below, area under
bIp = n. hundred thousand (number-forming element)
bIpIvHa'law'. = You seem unhealthy.
bIp'uy' = n. hundred billion (number-forming element)
bIQ = n. water
bIQ bal = n. water jug
bIQ beb = n. surface of water
bIQ Duj = n. ship, boat
bIQ ghaywI' pa' = n. shower (room)
bIQ ghItmoHwI' = n. fountain
bIQ na' = n. brackish water
bIQ notron = n. waterfall
bIQ ngaS HIvje'. = be quite mistaken, be totally wrong
bIQ SeHjan = n. faucet
bIQ SeHmeH jan = n. {bIQ SeHjan:n}
bIQDep = n. fish, sea creature
bIQSIp = n. hydrogen
bIQSIp 'ugh = n. deuterium isotope
bIQ'a' = n. ocean, sea
bIQ'a' HeH = n. beach
bIQ'a'Daq 'oHtaH 'etlh'e'. = The sword is in the ocean.
bIQapqu'meH tar DaSop 'e' DatIvnIS. = To really succeed, you must enjoy eating poison.
bIQongtaHvIS nItlhejchugh targhmey bIvemDI' nItlhej ghIlab ghewmey. = If you sleep with targs, you'll wake up with glob flies.
bIr = v. be cold
bIraqlul = n. brak'lul (redundancy in body parts)
bIrchoH SuvwI' 'Iw. = The blood of the warrior grows cold.
bIrchugh qIvon tuj 'Iw. = If the qIvon is cold, the blood is hot.
bIreqtal = n. Brek'tal ritual
bIreQ = n. bregit
bIreQtagh = n. bregit lung
bISovbejbe'DI' tImer. = When in doubt, surprise them.
bISutlhnISchugh jaghlI' mInDu' tIbej. = If you must negotiate, watch your enemy's eyes.
bISuv 'e' yIwIv; bISutlh 'e' yIwIvQo'. = Choose to fight, not negotiate.
bISuvtaHvIS bIHeghjaj! = May you die in battle!
bIt = v. be nervous, be uneasy
bItaHrup'a'? = Are you prepared to continue?
bItuHlaHbe'chugh bIquvlaHbe'. = If you cannot be shamed, you cannot be honored.
bItuHpa' bIHeghjaj. = Death before shame.
bItlh = v. adapt to, get used to, acclimatize to, conform to, become adjusted to
bIv = v. break (rules)
bIyaj'a'? = Do you understand?
bIyem'a'? = Will you sin?
bIyIntaH 'e' Daqotlhbe'. = You do not deserve to live.
bI' = v. sweep (away)
bI'IQchugh yIvang! = If you are sad, act!
bI'rel tlharghDuj = n. B'rel Scout
bI'reS taymey = n. prologue
bI'reS 'echlet = n. front cover (of book)
bo = n. feather
bo- = v. you (plural)-him/her/it/them
boch = v. shine, be shiny
bochmoHwI' = n. sycophant, flatterer
boD = n. forehead
bogh = v. be born
bogh tlhInganpu', SuvwI'pu' moj, Hegh. = Klingons are born, live as warriors, then die.
boH = v. be impatient
boj = v. nag
bol = v. drool
bol = v. betray
bolwI' = n. traitor
bom = v. sing, chant
bom mu' = n. lyric, lyrics
bomDI' 'IwwIj qaqaw. = The memory of you sings in my blood.
bomwI' = n. singer
bon = v. share with
bop = v. be about, be concerned with
boq = n. alliance, bloc, coalition
boq = n. fusion
boq = v. ally with, form an alliance with
boq = v. add (used in math)
boqHa' = v. subtract (used in math)
boq'egh = v. multiply (used in math)
boqHa''egh = v. divide (used in math)
boq Hol = n. pidgin, creole, contact language
boq ru' = n. coalition
boqrat = n. type of animal, bokrat
boqyIn = n. symbiont
boQ = n. aide
boQ = n. aid, assistance
boQ = v. assist
boQDu' = n. aide-de-camp
boQ Hol = n. {boq Hol:n}
bor = v. gurgle
borqu' = v. thunder
borgh = n. Borg
borghel = n. a very small bird whose eggs are considered quite tasty
bortaS = n. revenge
bortaS bIr jablu'DI' reH QaQqu' nay'. = Revenge is a dish which is best served cold.
bortaS DIb = n. Right of Vengeance
bortaS nIvqu' 'oH bortaS'e'. = Revenge is the best revenge.
boS = v. collect
bot = v. prevent, block, prohibit
botjan = n. shields (force field on ship)
botjan HoS SIlwI' = n. shield energy diverter
botjan yIchu'! = Raise shields!
botlh = n. center, middle
botlh = n. median (used in math)
bov tIQ = n. ancient era
bo'Dagh'a' lo' = exaggerate
bo'DaghHom lo' = minimize the importance of something
bo'DIj nompuq = n. forensic evidence
bo'DIj pa' = n. courtroom
bo'DIj qach = n. courthouse
bo'DIj qaD = n. lawsuit
bo'retlh = n. Boreth
buD = v. be lazy
buj = v. be neither warm nor cool (temperature)
bulvar = n. monk, nun
bum = v. absorb
bup = v. quit
buQ = v. threaten
bur = v. hiccup
bur DIS = leap year
burgh = n. stomach
burgh quD = n. naturally produced {quD:n:nolink}
buS = v. concentrate on, focus on, think only about
buSHa' = v. ignore
but = v. be natural
butlh = n. dirt under fingernails
butlh = n. quality that is similar to what humans call "gall"
butlh ghajbogh nuv'e' yIHo'. = Admire the person with dirt under his fingernails.
buv = v. classify
buy' = v. be full, be filled up
bu' = n. sergeant
cha = n. torpedoes
cha yIghuS! = Stand by on torpedoes!
chab = n. pie, tart, dumpling
chab = n. invention, innovation
chab chu' = n. new invention, latest innovation
chabal tetlh = n. wish list
chabHom = n. cookie
chach Duj = n. ambulance, emergency vehicle
chagh = v. drop
chaH = n. they, them (capable of using language)
chaj = n. close female friend of a female
chal = n. sky
chal bIQ = n. rain
chal chuch = n. snow
chalqach = n. tower
chaltoq loS = n. Chaltok IV
chamwI' = n. technician
chanDoq = n. marinade
chanDoq jeD = n. thick marinade
chang = v. be gelatinous
chap = n. back (of hand)
chap = v. be official, be authenticated, be authorized, be legitimate
chaQ = v. thrust upward with end of bat'leth
char = v. be slimy
chargh = v. conquer
charghbej vIt. = The truth shall conquer.
charghwI' = n. victor, conqueror
chatlh = n. soup (thick)
chatlh = n. nonsense, balderdash
chav = v. achieve
chav = n. achievement
chaw' = v. allow, permit
chaw' ngoq = n. password, passcode
chayqa' = n. esophagus
chay' Dochvam vIlo'? = How do I use this? What do I do with this?
chay' jura'? = What are your orders?
chay' mu'vam qollu'? = How is this word pronounced?
cha' = v. show, display (picture)
cha' = n. two
cha'DIch = n. second (ordinal number)
cha'DIch = n. second, aide (role in Klingon legal system)
cha'Hu' = n. day before yesterday
cha'leS = n. day after tomorrow
cha'maH = n. twenty
cha'bIp = n. a bird noted for its speed
cha'Do' = n. a species of Klingon bird about which little is known
cha'maH cha' joQDu' = n. twenty-two ribs
cha'naS = n. a small bird which digs up bugs to eat
cha'neH = n. forearm
cha'par = n. a bird noted for its song
cha'pujqut = n. dilithium crystal
cha'puj pa' = n. dilithium chamber
cha'qu' = n. a bird with a noisy, repetitive cry
cha'vatlh ben HIq = n. two century old ale
cha''etlh DaSwI' = n. tweezer
cha''etlh pe'wI' = n. scissors
cha' DoSmey DIqIp. = We disagree.
cha' qabDu' = n. two faces
che- = v. you (plural)-us
cheb'a' = n. unit of weight, mass
chech = v. be drunk, be intoxicated
chegh = v. return (to)
cheH = v. defect
chej = n. liver
chel = v. add
chelwI' = n. accountant, financier
chem = v. prank
chemvaH = n. type of animal, chemvah
chen = v. build up, take form
chenmoH = v. form, make, create
chenmoHlu'meH Daq = n. construction site
chenmoHwI' = n. creator, maker
cheng = n. Chang
chep = v. prosper, be prosperous
cheq = v. tornado
cheqwI' = n. {lunglIH:n}
cheqotlhchugh maHaghbe''a'? cheDuQchugh mareghbe''a'? cheQIHchugh manoDbe''a'? = Tickle us, do we not laugh? Prick us, do we not bleed? Wrong us, shall we not seek revenge?
cher = v. establish, set up
chergh = v. tolerate
cheS = n. type of animal, rabbit (Klingon animal with long ears)
cheSvel = n. type of coat
cheSvel = n. coat, jacket
chetvI' = n. torpedo tube
chetvI' = n. spear-throwing device
chev = v. separate
chevwI' tlhoy' = n. territorial wall (e.g., Berlin Wall)
cheyIS = n. cephalopod
che' = v. rule, reign, run, preside
chI = v. menstruate, undergo menstruation
chID = v. admit
chIj = v. navigate
chIjwI' = n. navigator
chIl = v. lose, misplace, be unable to find, lose track of
chIm = v. be empty, be deserted, be uninhabited
chIp = v. cut, trim (hair)
chIq = v. cross, traverse
chIS = v. be white
chItlh = v. be symmetrical
chIw = v. express, embody, exude, epitomize
chI'ID = n. uterus
cho- = v. you-me
chob'a' = n. main corridor
choghvat = n. stairway leading to a door of a ship, gangplank
choghvat = n. porch
choghvat pa' = n. {choghvat:n:2}
choH = v. alter, change
choH lISbogh Hap'e' = n. reaction moderating element
chol = v. close in, get closer, come nearer
chon bom = n. hunting song
chonnaQ = n. hunting spear
chontay = n. ritual hunt
chong = v. be vertical
chong = v. be profound, be thorough, be careful, be good, be excellent
chop = v. bite
choptaH = v. gnaw
chop'a'? = Does it bite?
choq = v. preserve, save
chor = n. belly, midsection
chor = n. {chor bargh:n}
chor bargh = n. ceramic flat-bottomed pot
chorgh = n. eight
chorghDIch = n. eighth
chorghmaH = n. eighty
chorgh = n. eighth tone of nonatonic music scale
chorgh = v. be glossy
choS = v. desert
chot = v. murder
chotwI' = n. murderer
chotlh = v. stare at, gaze at, observe
chov = v. assess, evaluate
cho' = v. succeed (to authority)
cho' 'oDwI' = n. Arbiter of Succession
chuch ngogh = n. solid block of ice, ice cube
chuch 'aplom = n. hailstone
chuH = v. throw (a spear) at, hurl (a spear) at
chuH = v. explain clearly to, clarify for, specify for
chul = v. be wise
chum = v. be colourful
chun = v. be innocent
chung = v. accelerate
chungwI' = n. accelerator
chungHa'wI' = n. brake
chup = v. recommend, suggest
chuq'a' = n. long range
chuq'a' leghwI' = n. space telescope
chur = v. be uncomfortable (physically)
churHa' = v. be comfortable (physically)
chuS = v. be noisy
chuSwI' = n. type of rodent
chuS'ugh = n. type of musical instrument
chut qeSwI' = n. lawyer
chuv = v. be left over
chuv = n. leftover
chuv = n. change (money)
chuvmey = n. leftovers (grammatical term)
chuy = v. sneeze
chuyDaH = n. thrusters
chu' = v. be new
chu' = v. engage, activate (a device)
chu' = v. play (a musical instrument)
chu'Ha' = v. disengage, deactivate (a device)
chu'wI' = n. trigger
chu'wI' = n. player (of an instrument)
Da = v. behave as, act in the manner of
Da- = v. you-him/her/it/them
Dab = v. dwell in/at, reside in/at
DabuQlu'DI' yISuv. = When threatened, fight.
Dach = v. be absent
Dach = v. be not attentive, be distracted, lack focus
Daghor tuq = n. House of D'Ghor
Daghtuj = n. mixture of animal parts, animal parts mixed together
DaH jIbwIj vISay'nISmoH. = I must wash my hair now.
DaH yIDIl! = Pay now!
DaHjaj = n. today
DaHjaj SuvwI''e' jIH. = Today I am a warrior.
DaHjaj SuvwI' SoH. = Today you are a warrior.
DaHjaj gheD = n. dish in a restaurant, "catch of the day"
DaHjaj ram = n. tonight
DaHpem = n. daytime today
DaHpo = n. morning today
DaHpov = n. afternoon today
DaHram = n. {DaHjaj ram:n}
Daj = v. be interesting
Daj = v. test inconclusively
Dajonlu'pa' bIHeghjaj. = May you die before you are captured.
Dal = v. be boring
Dal pagh jagh. = No enemy is boring.
Dam = v. regard as, view as, consider (treat somebody like)
DamSayrotlh = n. type of animal, hippopotamus (hippo-like Klingon animal)
Dan = v. occupy (military term)
Dang = v. focus (visual)
Dap = n. nonsense
Dap bom = n. nonsense song
Daq = v. eavesdrop
Daq = n. site, location
Daq'a' = n. jurisdiction, territory
Daq noy = n. landmark (not a building)
DaqwIj vISovbe'. = I'm lost.
DaqQeD = n. {renyarDaq QeD:n}
Daqtagh = n. warrior's knife, d'k tahg
Daqturaq = n. d'akturak, "ice man"
DaQ = n. ponytail
Dargh = n. tea
Dargh wIb = n. sour tea
Dargh HIvje' = n. teacup
DaS = n. boot
DaS = v. pinch
DaSpu' = n. boot spike
Dav = v. sidestep, sway
Dav = v. sway (aircraft moves to the side without yawing)
DawI' = n. actor, actress
Daw' = v. revolt
Day = v. compare
DaynguH = n. testicle
DayquS = n. type of plant, dikus plant
Da' = n. corporal (rank)
Da'ar = n. Dahar Master
Da'nal = n. a bird characterized by erratic, unpredictable behavior
Da'vI' = n. a bird characterized by erratic, unpredictable behavior
Dech = v. surround
Degh = n. medal, emblem, symbol, insignia
Degh = n. helm
Degh = v. act without a plan, improvise
DeghwI' = n. helmsman
DeH = v. be ripe, be overripe (fruit, vegetable)
Dej = v. collapse
Dejpu'bogh Hov rur qablIj! = Your face looks like a collapsed star!
Del = v. describe
Dem = v. be clear, be transparent, be colourless
DenIb = n. Deneb
DenIbya' = n. {DenIb:n}
DenIb Qatlh = n. Denebian slime devil
DenIbya' Qatlh = n. {DenIb Qatlh:n}
DenIbngan = n. Denebian
DenIbya'ngan = n. {DenIbngan:n}
DennaS = n. Dennas
Deq = v. (be) erstwhile, former, prior, ex-
Der = v. veer (to the left or right while traveling or moving)
Der = v. yaw (aircraft nose points left or right)
Dergh = v. surrender (something), relinquish, give away, let go of
DeS = n. arm (body part)
DeS = n. ax handle
DeSqIv = n. elbow
DeS Do'ghI' = n. forearm (inner side)
DeS nev'ob = n. upper arm
DeS reStav = n. forearm (outer side)
DeS tutren = n. elbow pit
DeSwar bIr = n. refrigerator
Dev = v. lead, guide
DevmeH paq = n. guide book
DevwI' = n. leader
De' = n. data, information
De' chu' = n. update, news
De' chu' ghItlh = n. newspaper
De' jengva' = n. CD, data disc
De' lI' Sovlu'DI' chaq Do'Ha'. = Knowledge of useful information may be unfortunate.
De' naw'wI' = n. data access
De' ngop = n. CDs, data discs
De' QulwI' = n. librarian
De'wI' = n. computer
De'wI' loHjan = n. {loHjan:n}
De'wI' nItlh 'echlet = n. {nItlh 'echlet:n}
De'wI' pat = n. computer system
De'wI' Qulpa' = n. computer research lab
De'wI' SoSbor'a' = n. main computer core
De'wI' tIS = n. {De'wI'Hom:n}
De'wI' turwI' = n. computer server
De'wI' 'echlet Hab = n. {'echlet Hab:n}
De'wI'Hom = n. laptop computer, mobile computer
DI yoD = n. blast debris shield
DI- = v. we-them
-DIch = n. ordinal number (suffix)
DID = v. be stereotypical
DIgh = v. undertake, deal with
DIghna' = n. type of plant, digna
DIghna' por = n. digna leaf
DIj = v. slide sword blade along opponent's blade
DIj = v. use a pigment stick, paint with pigment stick
DIjwI' = n. artist, painter
DIl = v. pay for
DIlmeH Huch = n. price
DIlyum = n. trillium (a traded commodity)
DIng = v. spin
DIngwI' = n. turntable (music)
DIp = n. noun
DIr = n. skin
DIr bID = n. {DIr paH bID:n}
DIr paH bID = n. kilt-like garment
DIr QanwI' taS = n. suntan lotion
DIr rop = n. type of skin disease
DIr tutlh = n. tattoo
DIr 'In = n. skin drum
DIS = n. cave
DIS = n. year (Klingon)
DIS = v. confess
DIS chu' = n. New Year
DISjaj = n. anniversary
DISqa'vI'rIy = n. Discovery
DItlh = v. be unavenged
DItlhHa' = v. be avenged
DIv = v. be guilty
DIvI' Hol = n. Federation Standard, English (language)
DIvI' Hol Dajatlh'a'? = Do you speak Federation Standard?
DIvI'may'Duj = n. Federation battle cruiser
DIy = v. be stuck (physically won't budge)
DI' = v. edit, revise, correct, modify
DI'raq = n. type of animal, sheep (fluffy, woolly, shaggy Klingon animal)
DI'ruj QeD = n. metaphysics
DI'ruj velqa' = n. virtual reality
Do Qe' = n. fast-food restaurant, Dok'e
Do qaD = n. race (contest of speed)
Doch = v. be rude
DochHa' = v. be polite, be civil, be courteous
Doch = n. thing
Dochvam nuq? = What is this?
Dochvetlh DIlmeH Huch 'ar DaneH? = How much do you want for that?
Dochvetlh vISoplaHbe'. = I can't eat that.
Dochvetlh vItlhutlhlaHbe'. = I can't drink that.
Dogh = v. be foolish, be silly
DoH = v. back away from, back off, get away from
DoHmoH = v. drive back
Dojmey = n. mass, masses, multitude, a very large but indeterminate group of something
Doj tlhum = n. bundle
Doj = v. be impressive
Dol DIp = n. singular noun (grammar)
Dol mI' = n. integer
Don = v. be parallel, go parallel to
DonHa' = v. be misaligned
Dop = v. be opposite, be antithetical, be contradictory
Dop = v. be negative (used in math)
DopmoH = v. reverse (e.g., a list)
DopDaq qul yIchenmoH QobDI' ghu'. = Set fire on the side when there is danger.
Doq = v. be orange, be red
Doq bIQtIq bIQ = something momentous has happened
Doq 'ej Qaj wuS rur = to be a particular shade of brown
Doq 'ej wovbe' = be brown
DoQ = v. claim (territory)
DoQmIv'a' = n. bathtub, swimming pool
Dor = v. escort
Dor = v. end (of a period of time)
DoS = n. target
DoS chIl = to digress
Doy' = v. be tired
Doy'yuS = n. Troyius
Do' = v. be fortunate, be lucky
Do'Ha' = v. be unfortunate
Do'Ha'. = That is unfortunate.
Do'ghI' = n. calf (back of lower leg)
Do'ol HuD = n. dune
Do'ol na' = n. salt (culinary, halite)
Do'ol raS'IS = n. grain of sand
Du- = v. he/she/it-you
Dub = n. back (of body)
Dub = v. improve
Dubotchugh yIpummoH. = If it's in your way, knock it down.
DuD = v. mix
DuDwI' = n. stirring stick
Dugh = v. be vigilant
DughrI' = n. skull
DuH = v. be possible
DuHSum = n. type of animal, lobster (Klingon animal found in water with a huge claw)
Duj = n. ship, vessel
Duj = n. instinct, instincts
Duj ngaDHa' = n. irresponsible person, undisciplined person
Duj tIvoqtaH. = Always trust your instincts.
DujDaj HubtaHvIS Hegh 'e' tul Hoch tlhIngan. = To die defending his ship is the hope of every Klingon.
Dujeychugh jagh nIv yItuHQo'. = There is nothing shameful in falling before a superior enemy.
DujlIj yIvoq. = Trust your instincts.
Dujmey law' chIjpu' = has navigated many ships
Dul = v. sigh
Dum = v. nap
Dun = v. be wonderful, be great
Dung = n. area above, area overhead
Duq = v. be stunned (like {yay':v:nolink} but stronger)
DuQ = v. stab
DuQ = v. touch (emotionally)
DuQwI' = n. spike (attached to something)
DuQwI'Hom = n. little spike
Duran lung = n. Durani lizard
Duran lung DIr = n. Durani lizard skins
DuraS = n. Duras
Durghang qung = n. keyhole
Dut = v. slam down
Dut = v. stress, emphasize
Duv = v. advance
Duy = n. agent, emissary
Duy' = v. be defective
Duy'a' = n. ambassador
Du'Hom = n. garden
Du'Hom mI' = n. random number
Du' naH = n. produce
Du'IHchoHmoH mIvvam. = This helmet suits you.
Du'QamHom = n. type of flower, sunflower
Du'ran = n. philtrum
ghab = n. meat from midsection of animal
ghab tun = n. meat from midsection of animal, no bones
ghab = v. kill (when on a hunt)
ghach = v. lurk, lie in wait, lie low
ghagh = v. gargle
ghaH = n. he, she, him, her
ghaH vuv SuS neH = be foolish, be a fool
ghaj = v. have, possess
ghajwI' = n. owner
ghal = v. be jealous (of), envy
gham = n. limb (of an animal)
ghan = v. be hectic, be very active, be lively
ghanHa' = v. be peaceful, be calm
ghan = v. glance at, take a quick look at
ghanjaq = n. mace (stick, club)
ghanjaq chuS = n. rattle (baby toy)
ghan'Iq yaS = n. police officer
ghang = v. end prematurely (an event, voyage, battle, play, opera, story, song, etc.)
ghangwI' = n. horizon
ghapqa' = n. jaw
ghaq = v. contribute
ghar = v. conduct diplomacy
gharwI' = n. diplomat
ghargh = n. serpent, worm
ghaS = v. indicate, signal
ghatlh = v. dominate
ghav 'uSqan = n. steel
ghaw = v. excavate (a hole, a trench)
ghawran = n. Gowron
ghaw' = n. igvah liver soup
ghaw' = n. insecure one, one full of self-doubt
ghaw' = n. gum (oral anatomy)
ghay = v. spray, bombard, rain down
gha'cher = n. goat-like creature
gha'poq = n. grapok sauce
gha'vIq = n. Grafk
ghegh = v. be rough
gheH = v. have a temperature of
ghel = v. ask (a question)
ghep = v. hug, embrace
gher = v. formulate, compile, pull together
gheS = v. assume duties of, take on responsibilities of
ghet = v. pretend
ghetwI' = n. pretender
ghevchoq = n. Gevchok
ghevchoq Sep = n. Gevchok region
ghevI' = n. sauce for gagh
ghew = n. bug, cootie
ghew Duj = n. helicopter
ghewmey = n. punctuation
ghe' = v. be transformed, be transmuted, be metamorphosed, be totally altered
ghe'naQ nIt = n. grand opera
ghe'tor = n. Gre'thor, netherworld (where spirits of dishonored go)
ghe'torvo' narghDI' qa'pu' = when spirits escape from Gre'thor
ghe''or = n. {ghe'tor:n:place}
ghe''orDaq luSpet 'oH DaqlIj'e'! = You belong in a black hole in the netherworld!
ghIb = v. consent
ghIch = n. nose
ghIchwIj DabochmoHchugh ghIchlIj qanob. = If you shine my nose, I will give you your nose.
ghID = v. pierce, perforate
ghIgh = n. necklace
ghIgh = n. assignment, task, duty
ghIgh yIvbeH = n. turtleneck (clothing)
ghIH = v. be messy, be sloppy
ghIH = v. be careless
ghIj = v. scare
ghIj qet jaghmeyjaj. = May your enemies run with fear.
ghIl = v. be the mean, be the average (arithmetic mean, used in math)
ghIlab ghewmey tIbuSQo'. = Pay no heed to glob flies.
ghIm = v. exile
ghImwI' = n. exhaust
ghIn pIn = n. abbot, abbess
ghIntaq = n. battle spear, Gin'tak
ghIpDIj = v. court-martial
ghIQ = v. vacation, take a vacation
ghIr = v. descend
ghIrIlqa' = n. Grilka
ghIS = v. wiggle, squirm
ghISDen = n. scales (animal covering)
ghISnar = n. Grishnar cat
ghIt = n. open, flat hand
ghIt = n. ax blade
ghIt = v. flow (e.g., water), gush, spout
ghItwI' = n. geyser
ghItlh = n. manuscript
ghItlh = v. engrave, incise, mark (upon), write
ghItlhmeH Ho'DoS = n. writing system
ghItlhwI' = n. stylus, engraver
ghItlhwI' 'echlet = n. marker board, flip chart
ghItlh raS = n. desk
ghIv = n. limb (of a person)
ghI'boj = n. G'boj
gho- = v. imperative: you-us, you (plural)-us
gho lang = n. oval
gho paq = n. binder, notebook
gho SubmaH = n. pi
gho tut = n. cylinder
gho 'Impey' = n. cone
ghob = v. fight, battle, do battle, wage war
ghob tIvnISbe'lu'. = One need not enjoy virtue.
ghobchuq loDnI'pu' = n. The Brothers Fight One Another
ghoch = v. track, track down
ghochwI' = n. "Tracker" (constellation where Kahless prophesied he would return)
ghoD = v. stuff
ghogh = n. voice
ghogh HablI' = n. telephone
ghoH = v. argue, dispute
ghoj = v. learn
ghojmeH mIw = n. lesson
ghojmeH taj = n. boy's knife
ghojmoH = v. teach, instruct
ghojmoHwI' = n. teacher, mentor
ghojwI' = n. student
ghojwI'pu'lI' tISaH. = Care about your students.
ghol = n. opponent, adversary
ghom = n. band, group, party
ghom = v. meet, encounter, assemble, rendezvous
ghomHa' = v. scatter, disperse
ghommeH yotlh = n. plaza, courtyard
ghom'a' = n. crowd
ghom DIp = n. plural noun (grammar)
ghom ngoy' = n. roster, duty roster
ghomaH = n. {gho SubmaH:n}
ghon = v. sparkle, glitter
ghonDoq = n. type of knife (slender blade)
ghong = v. abuse, exploit
ghop = n. hand
ghop 'etlh = n. a kind of blade
ghoq = v. spy, spy on
ghoqwI' = n. spy
ghoQ = v. be fresh, be just killed (meat)
ghoQ = v. be most recent
ghoQaH! = Help us!
ghor = v. break
ghor = n. surface (of a planet)
ghorgh mamej? = When do we leave?
ghorgh tujchoHpu' bIQ? = When will the water be hot?
ghormaghenDer = n. gormagander
ghorqan = n. Gorkon (Chancellor)
ghor'In = n. Gorn
ghoS = v. approach, go away from, proceed, come, follow (a course)
ghoS = v. thrust
ghot = n. person (humanoid)
ghotpu' tamey = n. personnel files
ghotI' = n. fish, most general word for fish-like creature
ghov = v. recognize
gho' = v. step on
gho'rIch = n. zit, acne, "gorch"
gho''ong Ho'DoS = n. magic (trick) technique
ghu = n. baby
ghubDaQ = n. firstborn
ghuch = v. climax (sexual)
ghugh = v. vocalize
ghuD = v. be in common, be co-
ghughugh = v. growl
ghuH = v. prepare for, be alerted to
ghuHmoH = v. alert, warn
ghuj = v. pivot, swivel
ghum = v. alarm, sound an alarm
ghun = v. program (a computer)
ghun = v. be warm
ghung = v. be hungry
ghup = v. swallow
ghur = v. increase
ghuS = v. be prepared, be ready (to launch)
ghuS = v. lower (spear) to horizontal to attack
ghut = v. predict
ghuy' po'qu'! = Damn he's good!
ghu' neS = n. {jInbo':n}
Hay = n. the consonant {H:sen:nolink}
Hab = v. be smooth
Hab SoSlI' Quch! = Your mother has a smooth forehead!
Hach = v. be developed (e.g., civilization)
HaD = v. study
Hagh = v. laugh
Hagh qoHpu' neH HeghtaHvIS SuvwI'pu'. = Only fools laugh while warriors die.
HaH = v. soak, drench
HaH = v. marinate
Haj = v. dread
Hajvav = n. type of animal, weasel-like Klingon creature
Hal = n. source
Hal = v. be porous
Ham = v. be high (in pitch)
Hampong DIr = n. scab
Hampun = v. yodel
Han = v. be learned, be scholarly, be erudite
Hap choHwI' = n. replicator
HapQeD = n. physics
Haptej = n. physicist
Haq = v. perform surgery (on)
Haq = v. intervene in (a situation)
Haq = v. tinker
Haqtaj = n. scalpel
HaqwI' = n. surgeon
Har = v. believe
Hargh = v. fight, battle (major confrontation)
HaS = v. squeak
HaSta = n. video (moving images)
HaSta = n. visual display (mode)
HaSta jIH = n. television
HaSta jIH much = n. {HaSta much:n}
HaSta much = n. TV show
HaSta ta = n. video, visual display record
Hat = v. be illegal
Hatlh = n. country, countryside
Haw = v. be random, be arbitrary, be unpredictable, be fortuitous
Haw' = v. flee, get out
Hay = n. area beyond
Hay = v. somersault
Hay' = v. duel
Hay'chu' = v. duel to the death
Ha'DIbaH = n. meat, animal
Ha'DIbaH = n. dog, cur, inferior person
Ha'DIbaH DaSop 'e' DaHechbe'chugh yIHoHQo'. = Do not kill an animal unless you intend to eat it.
Ha'DIbaH ghIH tIr ngogh je = n. burger, hamburger (Terran food)
Ha'on vevwI' = n. stapler
Ha'quj nge' = to wound one's pride
Hech = v. intend, mean to
HeD = v. retreat
HeDchu' = v. retreat perfectly, make a full withdrawal
HeDon = n. parallel course
Hegh = v. die
Hegh bey = n. death howl
Hegh Duj = n. Barge of the Dead
Hegh neH chav qoH. = A fool's only achievement is death.
Heghbat = n. ritual suicide
Heghba' = n. {Heghbat:n}
HeghDI' SuvwI' nargh SuvwI' qa'. = When a warrior dies, his spirit escapes.
Heghlu'DI' mobbe'lu'chugh QaQqu' Hegh wanI'. = Death is an experience best shared.
Heghlu'meH QaQ jajvam. = It is a good day to die.
HeghmoH = v. be fatal (to)
Heghtay = n. death ritual
Hej = v. rob
Hem = v. be proud
Hem tlhIngan Segh 'ej maHemtaH 'e' wIHech. = Klingons are a proud race, and we intend to go on being proud.
Hen = v. be experienced
HenrI' vagh = n. Henry V
Heng = v. finger (holes, strings of instrument) to vary sound
Heq = v. hail (weather)
HeQ = v. comply
Hergh ngevwI' = n. pharmacist, chemist, apothecary
Hergh qengbogh yo' = n. medical relief convoy
Hergh QaywI' = n. hypo, pneumatic hypo
HerghwI' = n. {Hergh QaywI':n}
Her'IS = n. bird with a long neck and long legs
HeS = v. commit a crime
HeSwI' = n. criminal
Hev = v. receive
Hew chenmoHwI' = n. sculptor
Hey = v. battle or fight against one's own group
Hey' = v. censor
He' = v. smell, emit odor
He'So' = v. stink
HI- = v. imperative: you-me, you (plural)-me
HID = v. sweat, perspire
HIgh = v. fight dirty
HIghoS! = Come here!
HIj = v. deliver, transport goods
HIjmeH chaw' = n. stamp, postage stamp
HIjmeH 'ap = n. customs (fee)
HIjmeH 'ap pIn = n. customs officer
HIjol! = Beam me aboard!
HIl = v. make someone's presence known
HIl'egh = v. make oneself's presence known
HIq = n. liquor, ale, beer, wine
HIq DaSammeH tach yI'el. = To find ale, go into a bar.
HIq HIvje' = n. beer stein
HIr = v. be stuck (physically fastened to something)
HIS = v. be compressed (as in air)
HIt = v. think, have an inner conversation
HItlh = v. be brittle
HItlhej! = Come with me!
HIq qIj = n. black ale
HIv = v. attack
HIvbe' qoHpu' neH. = Only fools don't attack.
HIvmeH Duj So'lu'. = A ship cloaks in order to attack.
HIvneS = v. honor-attack
HIvqa' veqlargh. = The Fek'lhr strikes again.
HIvje' = n. glass (drinking vessel)
HIvje' bom = n. drinking song
HIvje'He = n. piano in a piano bar
HI' = n. dictator
HI''a' = n. tyrant
Hob = v. yawn
Hoch = n. everyone, all, everything, each
HochDIch = n. end, last item in a list
HochHom = n. most, greater part
Hoch Holmey mughwI' = n. universal translator
Hoch jaghpu'Daj HoHbogh SuvwI' yIvup. = Pity the warrior who slays all his foes.
Hoch nuH qel = to consider every possibility
Hoch DaSopbe'chugh batlh bIHeghbe'. = Eat everything or you will die without honor.
Hoch 'ebmey tIjon. = Capture all opportunities.
HoD = n. captain (rank)
Hogh = n. week (Klingon)
Hoghjaj = n. anniversary (measured in weeks)
HoH = v. kill
HoHwI' = n. {romuluSngan Sambogh 'ej HoHbogh nejwI':n}
HoH'egh = v. commit suicide
Hoj = v. be cautious
HojnIy = n. teen, teenager, adolescent, youth, young adult
Hol = n. language
Hol ghoQ = n. fresh language
Hol Sar = n. dialect
HolQeD = n. linguistics
Holtej = n. linguist
Hom = n. bone
Hom = n. weakling, runt, scrawny one, skinny one
Hom = v. use the second toe
HomwI' = n. second toe
HomHap tun = n. cartilage
Hon = v. doubt
Hong boq chuyDaH = n. impulse fusion thrusters
Hongghor pat = n. impulse drive system
Hop = v. be remote, be far
Hoq = v. pull, drag
HoQ = v. be honored falsely, be falsely honorable
HoS = v. be strong
HoS = n. strength, energy, power
HoS choHwI' = n. transtator
HoS lIngwI' = n. power generator
HoS lI' Dalo'Ha'chu'! = You are a total waste of good energy!
HoS QaymeH 'och = n. power transfer conduit
HoS voveng = n. thyroid
HoS waw' = n. energy facility
HoS = n. amplitude
HoSDo' = n. energy beings
HoSghaj = v. be powerful
Hot = v. touch, feel
Hotlh = v. project, put on (screen)
Hotlh = v. scan
HotlhwI' = n. scanner
Hov ghajbe'bogh ram rur pegh ghajbe'bogh jaj. = A day without secrets is like a night without stars.
Hov lat = n. star shrine
Hov leng = n. Star Trek
Hov leng QeD = n. Treknology
Hovmey Davan. = You salute the stars.
HovQeD = n. astronomy
Hovtay' = n. star system
Hovtej = n. astronomer
Hov tut = n. telescope
Hoy = v. be refined, be fancy, be sophisticated (pertaining to culture)
Hoy' = v. congratulate
Ho' = v. admire
Ho' = n. tooth
Ho' = n. idol, someone worthy of emulation, something deserving of respect
Ho' = n. cog tooth, sprocket tooth
Ho' rutlh = n. cogwheel, sprocket wheel
Ho' SIryoD = n. braces on teeth
Ho' teywI' = n. toothbrush
Ho' 'etlh = n. serrated blade
Ho'Du' Say'moHwI' tlhagh = n. toothpaste
Ho'Du'lIjDaq to'baj 'uSHom lughoDlu'bogh tu'lu'. = You have some stuffed tobbaj leg in your teeth.
Ho''oy' = n. toothache
Ho'yI' = n. {HurwI':n}
Hub = v. defend
Hubbeq = n. {tlhIngan Hubbeq:n}
HubneS = v. honor-defend
Huch chaw' = n. credit card
Huch jengva' = n. coin
Huch nav = n. banknote, paper money
Huch nobHa'bogh verenganpu''e' yIvoqQo'. = Don't trust Ferengi who give back money.
Huch ngop = n. coins
HuchQeD = n. economics
HuD = n. mountain, hill
HuDqIj = n. the Black Hills
HuD beQ yoS = n. Flat Mountain district
HuDyuQ = n. HuDyuQ (name of planet)
HuD = n. breast
HuDngech = n. sine (curve)
Hugh = n. throat
Huj = v. be strange
Huj = v. charge (up)
Hum = v. be sticky
Human = n. human
Humlaw' = n. a creature like a {ghargh:n}, but with lots of wiggly legs
Hun = n. khrun, type of animal (used for riding)
Hup = v. punish
Huq = v. transact
HuqmeH 'ap = n. excise tax
Hur = v. pull, tug
HurwI' = n. bow (weapon)
HurDagh chuHwI' = n. {HurwI':n}
Hurgh = v. be dark
Hurgh = n. pickle (cucumber)
Hurgh Duj = n. submarine, blimp
Hur'Iq = n. outsider, foreigner
Hur'Iqngan = n. Hur'q (person)
HuS = v. hang
HuS = n. Huss
Hut = n. nine
HutDIch = n. ninth
HutmaH = n. ninety
HutmaH = n. climax (sexual)
Hutvav = n. nerve (anatomy, physiology)
Hutvav rarwI' = n. neural synapse
Hut'In tIq = n. weaving stick
Hut'In vIl = n. screw
Hutlh = v. lack, be without, to not have
Huv = v. be clear, be not obstructed
Huv = v. {qu':v:2,slang}
Huy = v. hum, purr
Huy = v. be spicy, be piquant, be hot
Huy = v. be libidinous
Huy' = n. eyebrow
Huy'Dung = n. forehead
Hu' = v. get up
jab = v. serve (food)
jabmeH = n. In Order to Serve
jabwI' = n. food server, waiter, waitress
jach = v. scream, cry out, shout, yell
jachwI'na' = n. Master of the Scream
jach SuvwI' 'e' yIQoy! = Hear the warrior cry out!
jaD = v. throw around, hurl about
jaDchu' = v. juggle (objects, not tasks)
jagh = n. enemy
jagh DajeymeH, nIteb yISuvrup. = To defeat the enemy, be ready to fight alone.
jagh lucharghlu'ta'bogh HuH ghopDu'lIj lungaSjaj. = May the bile of the vanquished fill your hands.
jagh yIbuStaH! = Focus on the enemy!
jaghla' = n. enemy commander
jaH = v. go
jaj = n. day (from dawn to dawn)
jajlo' chum = n. sunrise
jajlo' Qa' = n. a noisy animal (not a bird) known for making a ruckus at dawn (like a Terran rooster), type of animal
jajvam = n. today
jal = v. imagine, envision
jan = n. device
jan = n. musical instrument
janluq pIqarD = n. Jean-Luc Picard
jantor = n. witness (observer of an event)
jang = v. answer, reply
jaq = v. be bold
jaqmoH = v. embolden
jaQ = v. be deep
jaQHa' = v. be shallow
jar = n. month (Klingon)
jarjaj = n. anniversary (measured in months)
jargh = n. forehead
jat = n. tongue
jat = v. speak incoherently, mumble
jat = v. be clumsy
jat Hol = n. gibberish
jatlh = v. speak, say
jatlhHa' = v. misspeak, speak wrongly
jav = n. six
javDIch = n. sixth
javmaH = n. sixty
jav = n. sixth tone of nonatonic musical scale
jav = n. prisoner
jav mIS = n. confused prisoner, mixed-up prisoner, mixed-up six
javtIm raS'IS = n. vaccine
jaw = v. chat
jaw = n. {joH:n}
ja' = v. tell, report
ja'chuq = v. discuss, confer
ja'chuq = n. succession ritual (ancient)
jech = v. disguise
jeD = v. be thick, be dense, be viscous
jegh = v. surrender, give up, capitulate, acquiesce
jeghbe' tlhInganpu'. = Klingons do not surrender.
jeghpu'wI' = n. conquered person
jeH = v. be absentminded
jej = v. be sharp
jejHa' = v. be dull, be blunt (of blades)
jel = v. shake, tremble
jem = v. sense, feel, perceive, detect
jemS tIy qIrq = n. James T. Kirk
jen = v. be high
jentu' = n. a flightless aquatic bird
jengva' = n. plate (for eating)
jeq = v. protrude from
jeQ = v. be self-confident
jer = v. surge (aircraft suddenly moves forward or backward)
jergh = v. spasm
jeS = v. participate
jev = v. storm
jev = v. wheeze, breathe noisily
jey = v. defeat
jey' Sorpuq = n. bronze
jey'naS ghoqwI' = n. double agent
je' = v. buy, purchase
je' = v. feed (someone else), enrich spirit
je'wagh'en = n. louse-like Klingon bug
jI- = v. I-none
jIb = n. hair (on head)
jIb Ho'Du' = n. comb
jIb yachwI' = n. hairbrush
jIb = v. execute by hanging
jIb'egh = v. commit suicide by hanging
jIbechrup. = I am ready to suffer.
jIH = n. I, me
jIH = n. viewing screen
jIH = v. monitor
jIj = v. be cooperative, cooperate
jIjatlhpa' jatlh Hovmey. = The stars will talk before I will.
jIl = n. neighbor
jIlajneS. = I accept, your honor.
jIm = v. shrug
jIm = v. heave (aircraft rising or falling without pitching)
jIn = v. wish
jInay' = n. J'naii (planet)
jInay'ngan = n. J'naii (person)
jInjoq = n. type of bread
jInmol pa' = n. studio, workspace
jIqlem waq = n. sandal
jIr = v. rotate, twirl
jIrmoH = v. twirl bat'leth, cause bat'leth to rotate
jIrmoH = v. crank
jIrwI' Duj = n. helicopter
jIr qIvon = be libidinous
jISaHbe'. = I don't care.
jItuj'ep ngutlh = n. mummification glyph
jIv = v. be ignorant
jIvvo' = n. criminal, villain, malefactor
jIwuQ. = I have a headache.
jIy = v. be umami, be savory, be earthy
jIyaj. = I understand.
jIyajbe'. = I don't understand.
jo = n. resources
job = v. zigzag, be jagged
joch = v. be harmful
joD = v. stoop
joH = n. Lady, Lord (title for head of house)
joj = n. area between
jol = v. beam (aboard)
jolpa' yIjaH! = Go to the transporter room!
jol SeHlaw = n. transporter control panel
jol yIchu'! = Activate the transporter beam!
jom = v. install (a device)
jom = v. put clothes on (someone else)
jon = v. capture
jonHa' = v. release
jonpIn = n. engineering officer
jonSeH yaH = n. engineering, engine-control location
jonta' pa' = n. engineering, engine room
jonwI' = n. engineer
jop = v. lunge, thrust
jop = v. take turn
jopwI' jo' = n. recoil machinery
jop 'ej way' = to argue, have an argument
joq = v. flap, flutter, wave
joqwI' = n. flag
joqmoH = v. wave (a fan or anything else)
joQ = n. rib
joQ = n. strip of material in a susdek instrument
jor = v. explode
jornub = n. {jorneb:n}
jorwI' = n. explosive
jorchan velqa' = n. stage decoration
joS = v. gossip
jot = v. be calm
jot = v. be bland (referring to food)
jotHa' = v. be uneasy
jotlh = v. take down
jotlhHa' = v. put back up
joy' = v. torture
jo' = v. blow into a container of some kind
jo' = v. zoom in on
jo'Ha' = v. zoom out
ju- = v. you-us
jub = v. be immortal
jubbe' = v. be mortal
jubbe'wI' = n. mortal
juch = v. have a width of
juch = v. be at a longitude
juH = n. home
juHqo' = n. home world
juHwIjDaq Dochvetlh vItlhap. = I will take that to my home.
juH qach = n. house
julSIp = n. helium
jum = v. be odd
jun = v. evade, take evasive action
jup = n. friend
juS = v. overtake, pass
juv = v. measure
lay = n. the consonant {l:sen:nolink}
lab = v. transmit data (away from a place)
lach = v. exaggerate
laD = v. read
lagh = n. ensign
lagh = v. take apart, disassemble
laH = n. ability
laj = v. accept
lajQo' = v. reject
lam = v. be dirty
lam Ho'Du' = n. rake (for loosening soil)
lan = v. place
lang = v. be thin, be narrow
lap = v. vote, cast a ballot
laq = v. flap
laq = v. speak gibberish
laqlaq = n. gibberish
laQ = v. fire, energize (e.g., thrusters)
largh = v. smell, sense odors
laS = v. ink up, put paint on a brush
latlh = n. additional one, other one
latlh HIvje'Daq 'Iw HIq bIr yIqang! = Pour the cold bloodwine into another glass!
latlh je = et cetera
lav = v. lean, incline, slant
law = n. degree (traditional unit of angle)
law' = v. be many, be numerous
lay = n. air (technical term)
lay leng = n. aeronautics
lay' = v. promise
lay'Ha' = v. break one's word
la' = n. commander (specific rank)
la'pa' loS = n. Lappa IV
la'quv = n. Supreme Commander
la'SIv = n. turtle, tortoise
la''a' = n. commandant
lech = v. blackmail
lechtal = n. map line (traditional coordinate system)
lechvI' = n. map coordinate (traditional coordinate system)
leD = v. be perpendicular, be at a right angle
legh = v. see
leghlaHchu'be'chugh mIn lo'laHbe' taj jej. = A sharp knife is nothing without a sharp eye.
leH = v. maintain
lel = v. get out, take out
lem = n. hoof
lenmaq = n. Lenmak
leng = v. roam, travel, rove
lengwI' = n. rover (grammatical term)
leng buq = n. suitcase
leng chaw' = n. passport
leng Dotlh SeHwI' pat = n. flight reaction control system
leng Soj = n. voyage food, fast food
ler = v. wobble
lerchu' = v. oscillate
leS = v. rest, relax
leSpoH = n. shore leave
leSSov = n. foresight
let = v. be hard (like a rock)
letlh = n. stairs, stairway
letlh = n. stairway leading to door of a ship
lev = n. hard palate, roof of mouth
lev = v. move bat'leth from vertical to horizontal orientation
lew = v. bloom
ley' = n. nose
le' = v. be special, be exceptional
le'be' = v. be unexceptional, be nonspecific
lI- = v. he/she/it-you (plural), they-you (plural)
lIb = v. be impending, be imminent, loom
lIch = v. pour (into/onto anything)
lID = v. travel or move a specified or measurable distance or trajectory
lIgh = v. ride
lIghon = n. Ligon
lIghon DuQwI' pogh = n. glavin, Ligonian spike glove
lIghonngan = n. Ligonian
lIH = v. introduce
lIH = v. begin a song
lIj = v. forget
lIm = v. panic
lIl = v. simulate, impersonate
lIlwI' = n. simulator
lIn = v. share
lIn = v. go online (connect to computer network)
lInchuq = share each other
lInHa' = v. go offline (disconnect from computer network)
lIng = v. produce
lIngta' = n. type of animal, lingta
lIngwI' = n. generator
lIq = v. round up
lIQ = v. be stuck (mentally, on a problem)
lIr = n. a nocturnal bird
lIr'el = n. L'Rell
lIS = v. adjust
lIS'ab = n. type of rodent
lIt = v. get on (to)
lItHa' = v. get off (of)
lIw mu' = n. pronoun
lIwnal = n. concubine
lI' = v. be useful
lI' = v. transmit data (to a place)
lob = v. obey
lobHa' = v. disobey
loch = n. mustache
loch = v. be a fraction of, make up a portion of, constitute part of
loD = n. male, man
loD Quch jIHbe'. = I am not a merry man.
loDHom = n. boy
loDnal = n. husband
loDnI' = n. brother
-logh = n. times, number of times (repetition suffix)
loghDaq Suvrupbogh SuvwI'pu' chaH Hoch SuvwI'pu''e'. = In space, all warriors are cold warriors.
logh chal je 'angweD = n. planetarium
logh chal je 'angweD qach = n. planetarium (building)
logh Hop = n. deep space
logh Hop Hut tengchaH = n. Deep Space Nine
logh mIn = n. wormhole
logh'ob = n. chest
logh'ob = n. front (exterior surface)
loH = v. administer
loHjan = n. CPU
loHwI' = n. magistrate
loj = v. be all gone
lojmIt = n. door, gate
lojmIt poSDaq Daq pagh. = No one eavesdrops at an open door.
lol = v. be in a stance, be in a pose (people, animals, or martial arts)
lol = v. be in an attitude (aircraft)
lolchu' = v. be in a correct attitude (aircraft)
lolchu'taH = v. maintain a correct attitude (aircraft)
lolmoH = v. maneuver (an aircraft) to be in an attitude
lolSeHcha = n. attitude-control thrusters
loltaH = v. maintain an attitude (aircraft)
lon = v. abandon
lop = v. observe, celebrate (a ritual)
lopno' = n. party, celebration (a specific type of Klingon party or celebration)
loQ 'oy'DI' SuvwI' bepbe'. = A warrior does not complain about physical discomfort.
loq = v. be extinct
lor = n. cousin (cross-cousin; child of {'IrneH:n} or {'e'mam:n})
lor = n. nephew, niece (cross-nibling)
lorbe' = n. female cousin, niece (cross)
lorloD = n. male cousin, nephew (cross)
loS = v. wait (for)
loS = n. four
loSDIch = n. fourth
loSmaH = n. forty
loS = n. fourth tone of nonatonic musical scale
loS reD mey' = n. quadrilateral
lot = v. scratch
lotlh = v. rebel
lotlhwI' = n. rebel
lotlhmoq = n. a bird that swoops into the water in order to catch food, but cannot swim
loval = n. Loval
loy = v. guess
loy' = v. have personality, be charismatic, be charming
lo' = v. use, make use of
lo' law' = n. utility
lo' law' lojmIt = n. utility hatch
lo'laH = v. be valuable
lo'laHbe' = v. be worthless
lo'laHbe'ghach = n. worthlessness
lo'laHghach = n. value
lu = v. fall (suffer loss of status)
lu- = v. they-him/her/it
lugh = v. be right, be correct
luH = v. yank
luH = v. cause (someone) to confess or reveal a secret
luH = n. intestine
luHwI' tIH = n. tractor beam
luj = v. fail, lose (not win)
lujwI' mIr = n. losing streak
lul = v. fight, battle (relatively major fight)
lum = v. postpone, procrastinate
lumbe' tlhInganpu'. = Klingons do not procrastinate.
lun = v. swell, swell up
lung = n. type of animal, loong (lizardlike)
lunglIH Duj = n. helicopter
lungtal = n. map line (traditional coordinate system)
lungvI' = n. map coordinate (traditional coordinate system)
lup = v. transport
lupDujHom = n. shuttlecraft
lupwI' = n. jitney, bus
lupwI' mIr = n. train (vehicle)
luqara' = n. Lukara
lur = n. pupil (of eye)
lurSa' = n. Lursa
luS = v. be submerged in, be immersed in, be surrounded by
lut = n. story, tale
lut mIr = n. series (of stories, movies, etc.)
lut tlhaQ = n. funny story
lutlh = v. be primitive
ma- = v. we-none
mab = n. treaty, agreement, contract, commitment
mab = n. account (for using a service)
mabeb = n. toad-like or frog-like creature
mach = v. be small
magh = v. betray
maghwI' = n. traitor
magh yotlh = n. lawn
maH = n. we, us
maH = n. ten (number-forming element)
maHSaghan = n. ten billion (number-forming element)
maH'uy' = n. ten million (number-forming element)
majaj = n. cabbage, lettuce
majyang mIllogh = n. mosaic
majyang mutlhwI' = n. tiler, tile layer
malja' per = n. trademark
mang = n. soldier
mangghom = n. army
mangHom = n. cadet
maq = v. proclaim
maqlegh = n. priest, priestess
maqoch = n. buddy, pal, close male friend of a male
maqSung = n. bee, wasp
maQmIgh = n. dark omen, sign of evil coming
maQapmeH maHIv. = In order to succeed, we attack.
mar = v. use the big toe
marwI' = n. big toe, first toe
mara = n. Mara
marq 'oqranD = n. Marc Okrand
martaq = n. Martok
maS = v. prefer
maS = n. moon
maS So'lu'chu'bogh = n. new moon
maS'e' loQ So'lu'bogh = n. mostly full moon
maS'e' loQ So'be'bogh QIb = n. crescent moon
maS'e' So'bogh pagh = n. full moon
maS'e' loQHa' So'lu'bogh = n. {maS'e' loQ So'be'bogh QIb:n}
matSu' = n. commando
mataHmeH maSachnIS. = To survive, we must expand.
matay'DI' vIHtaHbogh bIQ rur mu'qaDmey. = Between us, curses run like water.
matHa' = n. gunner
matlh = v. be loyal
matlh = n. Maltz
matlhHa' = v. be disloyal
mavje' = n. liver
maw = v. offend
maw' = v. be crazy
may = v. be fair
may' = n. battle
may' bom = n. battle song
may' bom pIm bom = to speak of another matter entirely
may' ghe'naQ = n. battle opera
may' ngeb = n. mock battle
may' rImbey = n. adrenaline, epinephrine
may' Sut = n. body armor
may' ta = n. record of battle
may' vIloS. = I await battle.
may' yIghuH! = Battle alert!
may'Daq jaHDI' SuvwI' juppu'Daj lonbe'. = When a warrior goes to a battle, he does not abandon his friends.
may'meyDajvo' Haw'be' tlhIngan. = A Klingon does not run away from his battles.
may'Duj = n. battle cruiser
may'ron raS = n. piano (Terran musical instrument)
ma' = v. accommodate
ma'veq = n. type of knife
meb = n. guest
mebpa'mey = n. hotel
mech = v. trade
meHghem Qat = n. popular culture
mej = v. leave, depart
mej'aD = n. artery
melchoQ = n. marrow, bone marrow
mellota' = n. Melota
men = v. have an area of
mep vol = n. plastic sheet, vinyl
meq = n. reason, motive, logical thinking, topic, subject, theme
meq = v. reason, think logically
meqleH = n. mek'leth (type of weapon; smaller, one-handed version of bat'leth)
meqro'vaq Sep = n. Mekro'vak region
meQ = v. burn, be on fire
meQboghnom = n. Kahless' revolutionary banner
meQtaHbogh qachDaq Suv qoH neH. = Only a fool fights in a burning house.
meQ = v. burn, set on fire (food preparation)
meQ = v. be burnt (food preparation)
meQ = v. climax (sexual)
mer = v. surprise
mergh = v. be combined, be mixed together
meS = v. knot, tie a knot
meS = v. encrypt
meSHa' = v. unknot, untie a knot
meSHa' = v. decrypt
mev = v. stop, cease
mew' = v. cope (with), deal well (with), handle (a difficulty or challenge)
mey = v. match, fit onto, interlock with, interlace with, mesh with
me' = n. aunt (mother's sister)
me'nal = n. aunt (mother's brother's wife)
mIHneS = n. grasshopper
mIgh = v. be evil
mIjDang = n. fin, flipper
mIl = v. be formerly honored
mIllogh meyrI' = n. single-panel cartoon
mIllogh mIr = n. comic strip, cartoon
mIllogh ngutlh = n. hieroglyph, logograph
mIllogh qol = n. animation, cartoon
mIllogh qonwI' = n. camera
mIllogh qonwI' qoSta' = n. film (for camera)
mIl'oD = n. type of animal, sabre bear
mIl'oD ngeb = n. teddy bear
mIm = v. delay
mIn = n. eye
mInyoD = n. eyelid
mIn QanwI' nguv = n. sunglasses
mIn tojwI' = n. optical illusion
mIn yuq = perform magic
mIn yuqwI' = n. magician
mIn 'onroS = n. teardrop
mIp = v. be rich
mIQ = v. deep-fry
mIQ = n. forehead
mIr = n. chain
mIr = n. streak
mIS = v. be confused, be mixed up
mISmoH = v. confuse
mIStaq = n. ?Mishtak
mIt = v. be appropriate, be suitable, be proper for the situation
mItlh = v. forge (metal)
mIv = n. helmet
mIv = n. metal flat-bottomed pot
mIvDaq pogh cha' = a matter has been postponed or rescheduled
mIv bargh = n. metal flat-bottomed pot
mIv je DaS = n. fully dressed (as for a ceremonial affair)
mIv'a' = n. crown
mIvwa'mey poj = n. tally analysis, statistics
mIy = v. brag
mI' mob = n. odd number
mI' mobHa' = n. even number
mI' nagh = n. die, dice with numbers
mI' poj = n. number analysis, statistics
mI'QeD = n. mathematics
mI'tej = n. mathematician
mI' 'al = n. random number
mI' = v. dance, run in place, do calisthenics
mI'wI' = n. dancer
mI'wI' much = n. dance show
mI'lInnID = n. M'Lind
mob = v. be alone
mob = v. be odd (used in math)
mobHa' = v. be even (used in math)
moch = n. superior
moD = v. hurry
mogh = v. be frustrated
mogh = n. Mogh
moH = v. be ugly
moH = v. exert undue influence on
moj = v. become
mojaQ = n. {mojaq:n}
mol = v. bury
molHa' = v. dig up
molor = n. Molor
mon = v. smile, grin, sneer, snarl, smirk
mong = n. neck
mong Ha'quj = n. tie, necktie
mong'em = n. mong'em maneuver
moq = v. beat (something with an implement)
moQbID = n. dome
mor = v. be agile, be dextrous
moratlh = n. Morath
morgh = v. protest
morwI' = n. ant, formicidae
moS = v. compromise
mot = v. be stunned (rendered unconscious or dazed, like with a phaser)
motlh = v. be usual, be standard, be normal
motlhbe' = v. be unusual
mov = n. top of foot
mo' = n. cage
mo' = n. motive, motivation, grounds, reason, rationale
mo'qay tuq = n. House of Mo'Kai
mo'rISqa' = n. Morska
mo'rISqa'ngan = n. Morskan (person)
mu- = v. he/she/it-me, they-me
mub = v. be legal
much = v. present
much = v. perform (music)
much = v. strike a pose or stance (martial arts)
much jech = n. costume (e.g., for a stage play)
muchpa' = n. auditorium (room)
much qach = n. theater
much Qe' = n. cabaret (location)
muchwI' = n. musician
much yaH = n. stage
muD = n. atmosphere
muD = n. weather (in general)
muD Dotlh = n. weather (at any given moment)
muD Duj = n. airplane
muD ngeb SeHwI' pat = n. atmospheric control system
muDDaq 'eDSeHcha lulaQlu'bogh = n. atmospheric take-off/landing thrusters
muD 'umber = n. climate
mugh = v. translate
mughato' = n. mugato
mughbogh per = n. subtitle
mughwI' = n. translator
muH = v. execute, put to death
muj = v. be wrong, be incorrect, be factually wrong
mul = v. be stubborn
mum = v. taste, sense flavors
mum = v. fancy, have a crush on
mun = v. intervene
mup = v. impact, strike
mupwI' = n. hammer
mupwI' yI'uchtaH! = Keep holding the hammer!
mupwI'Hom = n. mallet (for striking a musical instrument)
muq = v. have a volume of
mur = v. wince, cringe, flinch
muS = v. hate, detest
muSHa' = v. love
mut = v. be selfish
mutchoH = n. {Hovje'voH:n}
mutwa' = n. protozoan
mutlh = v. construct, assemble, put together, manufacture
muv = v. join
muvchuqmoH = v. unite
muvmoH = v. recruit
muylIS = n. eyelash
mu' = n. word
mu'ghom = n. dictionary
mu'mey Doy' = n. tired words
mu'mey ghoQ = n. slang, fresh words
mu'mey qar = n. accurate words
mu'mey ru' = n. temporary words
mu'qaD = n. curse
mu'qaD veS = n. curse warfare, a kind of sport
mu'tay' = n. vocabulary
mu'tlhegh = n. sentence
mu'tlhegh meS = n. paragraph
nab = v. plan
nach = n. head
nach Ha'quj = n. scarf (for head)
naD = v. praise, commend, approve
naD tetlh = n. Commendation List
naDevvo' yIghoS! = Go away!
naDev Dochvetlh qem! = Bring that here!
naDev tlhInganpu' tu'lu'. = There are Klingons around here.
naDHa' = v. discommend, disapprove
naDHa'ghach = n. discommendation
naDqa'ghach = n. re-commendation
nagh beQ = n. stone panel (artwork, similar to a painting)
nagh DIr = n. shell (of an animal)
nagh HeH = n. curb
nagh tlhIl = n. quarry
naghboch = n. gemstone
naH = n. fruit, vegetable
naH jajmey = n. vegetable days
naH taj = n. vegetable knife, fruit knife (small knife)
naH tlhab = n. wild fruit, vegetable
naHjej = n. thistle
naHlet = n. nut, nuts
naHlet yub = n. nut shell
naHnagh = n. pit (of fruit)
naH = v. be hostile, be malicious, be unfriendly, be antagonistic
naj = v. dream
najmoHwI' = n. lullaby
nam = v. move counterclockwise
namwech = n. paw
nan = v. gouge
nan = v. use the fourth toe
nan = v. martial arts kick
nanwI' = n. chisel
nanwI' = n. fourth toe
nap = v. be simple
naQ = v. be full, be whole, be entire, be complete
naQ = n. cane, staff, stick
naQ = n. ponytail
naQHom = n. stick (used to strike percussion instrument)
naQjej = n. spear
naQjejHom = n. arrow (non-Klingon weaponry)
naQ 'er = n. brush devil, type of animal (a Klingon animal)
naq = v. be iridescent
nar = v. reflect
nargh = v. appear
nargh = v. escape
narghbe'chugh SuvwI' qa' taH may'. = If the warrior's spirit has not escaped, the battle is still going on.
naS = v. be vicious
natlh = v. use up, consume, expend, drain
natlh = v. be reprehensible, be disgusting, be contemptible
nav = n. paper, sheet of paper
nav HablI' = n. fax machine
nav qatwI' = n. envelope
nav QIn = n. letter (message written on paper)
nav vaH = n. envelope
naw' = v. access
nay = v. marry (wife does this)
nay' = n. course, dish (at a meal)
nay' Qav = n. last dish, last course (at a meal)
na' = v. be salty, be brackish
na' = v. be sure, be definite, be positive, be certain
na'ran = n. type of fruit
neb = n. beak, bill
neb = n. nozzle
neb mIv = n. baseball cap (Terran clothing)
nech = v. be lateral, move laterally
negh = n. soldiers
neghvar = n. Negh'Var (vessel)
neH = v. want
neHjej = n. {naHjej:n}
nej = v. look for, seek, search for
nejwI' = n. probe
nel = v. match, pair up, map onto
nelchu' = v. fit in perfectly, fit perfectly
nelwI' = n. partner (for objects which come in matching pairs)
nen = v. be mature, be grown-up, be adult
nenchoH = v. mature, grow up
nenghep = n. Age of Ascension
nentay = n. Rite of Ascension
nentay cha'DIch = n. Second Rite of Ascension
nep = v. lie, fib
neq = v. intersect
neS = v. be crunchy, be crispy
neSngech = n. dormouse-like animal (active during night), type of animal
net = n. that (previous topic)
netlh = n. ten thousand (number-forming element)
netlh DIS poH = n. myriad (a period of ten thousand years)
nevroD = n. tentacle
nev'ob = n. thigh, upper arm
ne' = n. yeoman
ne'Derlan = n. The Netherlands
nI- = v. they-you
nIb = v. be identical
nID = v. attempt, try
nIH = v. steal
nIHwI' = n. thief
nIj = v. leak
nIl = v. be grassy, be verdant
nIm tlhagh = n. butter
nIm qulcher taD = n. ice cream (Terran food)
nIm wIb ngogh = n. cheese
nIn 'ar wIghaj? = How much fuel do we have left?
nIpon = n. Japan
nIq = v. weave
nIqHom mI' = n. version number (major)
nIQ = n. breakfast
nIS = v. hinder, interfere (with), disrupt
nISwI' = n. disruptor
nISwI' beH = n. disruptor rifle
nISwI' DaH = n. disruptor banks
nISwI' HIch = n. disruptor pistol, hand-held disruptor
nISwI' tal = n. disruptor cannon
nIt = v. be plain, be pure, be uncorrupted, be unsullied
nIteb Qob qaD jup 'e' chaw'be' SuvwI'. = A warrior does not let a friend face danger alone.
nIteb DujlIj yIchIj. = Navigate your vessel alone.
nIteb SuvnIS DevwI'. = A leader must stand alone.
nItlh = n. finger
nItlh gheb = n. trumpet
nItlh naQ = n. pigment stick
nItlh Su'nIm = n. fingerprint (ridges on fingertip)
nItlh Su'nIm vem = n. fingerprint (mark left by touching)
nItlh 'echlet = n. keyboard
nItlhpach = n. fingernail
nItlhpach = n. flat end of a pigment stick
nIv = v. be superior
nIwqen = n. gill
nI' = v. be long, be lengthy (duration)
nob = n. gift
nob = v. give
nobHa' = v. give back, return
nobmey qembogh yIrIDnganpu''e' yIvoqQo'. = Don't trust Yridians who bring gifts.
nobmeD = n. skeleton (anatomy)
noch pat = n. remote sensing system
noD = v. retaliate
noDwI' = n. avenger
nogh = v. writhe
noH = v. judge, estimate
noH = n. war (an individual war)
noH ghoblu'DI' yay quv law' Hoch quv puS. = In war, there is nothing more honorable than victory.
noHva'Dut Sep = n. No'hvadut region
noH QapmeH wo' Qaw'lu'chugh yay chavbe'lu' 'ej wo' choqmeH may' DoHlu'chugh lujbe'lu'. = Destroying an empire to win a war is no victory, and ending a battle to save an empire is no defeat.
noj = v. lend
non = v. be rotten
nong = v. be passionate
nong = v. {qu':v:2,slang}
nop = v. omit
noq = n. nipple (anatomy)
noq = n. nipple (on bottles, etc.)
noregh = n. Norway
norgh = n. type of animal, norg (shark-like sea creature)
nortlham = n. descendant
noS = v. eat in small mouthfuls, nibble
not lay'Ha' tlhIngan. = No Klingon ever breaks his word.
not mev peghmey. = Secrets never cease.
not qoHpu''e' neH ghIjlu'. = Only fools have no fear.
not toj tlhInganpu'. = Klingons never bluff.
not vIleghpu'. = I've never seen him/her before.
notqa' = n. a large, black bird
notlh = v. be obsolete
notlh tonSaw'lIj. = Your argument is invalid.
nov = n. alien, outsider, foreigner
nov = v. be foreign, be alien
noy = v. be famous, be well-known
no' = n. ancestors, forebearers (culture or societal)
no' bov = n. ancestors' era
no' DIr = n. ancestor hanging (wall ornament)
no' Hol = n. ancient language, ancestors' language
no'QeD = n. genealogy
no'tej = n. genealogist
no''och = n. forehead
nu- = v. he/she/it-us, they-us
nub = v. be suspect
nuch = n. coward
nuch Hergh = n. aspirin
nuD = v. examine
nughQeD = n. sociology
nughtej = n. sociologist
nughI' = v. twist knuckle into someone's head
nuH = n. weapon
nuH = n. possibility
nuH bey' = n. Pride of Weapons (type of ceremonial display)
nuH HoS 'och = n. weapon(s) power conduit
nuHHom = n. small arms
nuHlIj DawIvpu', vaj yISuv! = You have chosen your weapon, so fight!
nuHmey = n. arsenal
nuHpIn = n. weapons officer
nuHotlhpu''a'? = Have they scanned us?
nuj = n. mouth
nuj yaj = read lips
nuj 'In = n. practice of making percussive sounds with mouth
num = v. promote
nung = v. precede
nup = v. decrease
nuqDaq Dochvam vIlan? = Where do I put this? What do I do with this?
nuqDaq jIQong? = Where do I sleep?
nuqDaq 'oH bIQ'a' HeH'e'? = Where is the beach?
nuqDaq 'oH puchpa''e'? = Where is the bathroom?
nuqDaq 'oH Qe' QaQ'e'? = Where is a good restaurant?
nuqDaq yuch Dapol? = Where do you keep the chocolate?
nuq Datlhutlh DaneH? = What do you want to drink?
nuq mI'lIj? = What is your number?
nuQ = v. annoy, bother
nural = n. Neural
nuralngan = n. Neuralese
nuS = v. ridicule
nuv = n. person (humanoid)
nu' = v. be particularly small
ngab = v. disappear, vanish
ngach = v. debate
ngaD = v. be stable, be balanced
ngaDmoH = v. stabilize
ngaDmoHwI' = n. stabilizer (component of a ship)
ngagh = v. mate with
ngaH = v. squeeze (an object)
ngaj = v. be short (in duration)
ngal = v. be chewy
ngam = v. adhere, stick
ngammoH = v. stick (something to something else)
ngan = n. inhabitant
ngang = v. vary, be varying
ngang = v. straddle
ngap = v. be consonant
ngapHa' = v. be discordant, be dissonant
ngaQ = v. be locked, be sealed, be secured, be fastened
ngaQmoH = v. lock, seal, secure, fasten
ngaQmoH = v. sign out, log out
ngaQHa'moH = v. unlock, unseal, unsecure, unfasten
ngaQHa'moH = v. sign in, log in
ngaQHa'moHwI' = n. key
ngaQ lojmIt = the door is locked
ngar = v. be miraculous, be supernatural, be wondrous
ngaS = v. contain (have inside)
ngaSwI' = n. container
ngat = n. gunpowder
ngat = n. herbed granulated cartilage (for food preparation)
ngat 'atlhqam = n. type of mold
ngavyaw' = n. large canine-like creature
ngaw = v. erode
nga'chuq = v. sex, perform sex
ngeb = v. be counterfeit, be false, be fake
ngech = n. valley
ngech = n. woman's cleavage
ngeD = v. be easy
ngeH = v. send
ngej = v. infect
ngel = v. attract, lure
ngelwI' = n. bait
ngem = n. forest, woods
ngem Ha'DIbaH = n. forest animal
ngem Sarghmey tlha' = chase forest sarks
ngen = v. be numb
ngeng = n. lake
ngeng HeH = n. shore
ngengroQ = n. type of sea creature
ngep = v. override
ngep'oS = n. stairs, stairway (except at ship door)
ngeq = v. store, hoard, cache
ngeQ = v. bump into, run into, collide with
nger = n. theory
ngeS = v. bake (subject is food)
ngeSmoH = v. bake (object is food)
ngeSlIch 'ap = n. interest (money)
ngetlh = v. diffract
ngev = v. sell
ngevwI' = n. seller
nge' = v. take away
ngIb = n. ankle
ngIb = n. slang term of deprecation
ngIbvay = n. type of animal (weird animal found on {Qo'noS:n} that looks like a rock)
ngIj = v. be rowdy, be unruly
ngIl = v. dare
ngIng = v. be negatively charged, have a negative charge
ngIm = v. be putrid
ngIn = v. be turbulent
ngIp = v. borrow
ngIr = v. knead, massage
ngItlh = v. be stuck (unable to move)
ngIv = v. patrol
ngI' = v. have a weight of, weigh
ngob'at = n. breast
ngoD = n. fact
ngoDHom = n. trivia, trivial fact
ngogh mutlhwI' = n. brick layer
ngogh tun = n. pillow (soft head support not used by Klingons)
ngoH = v. smear
ngoH = v. paint using fingers
ngoj = v. be restless
ngol = v. move bat'leth from horizontal to vertical orientation
ngom = v. be geeky
ngomwI' = n. geek
ngon = v. bubble
ngong = v. experiment
ngop = n. plates (for eating)
ngoqDe' = n. encoded message
ngoQ = n. goal, purpose
ngor = v. cheat
ngoS = v. dissolve
ngottal = n. map line (traditional coordinate system)
ngotvI' = n. map coordinate (traditional coordinate system)
ngotlh = v. be fanatical
ngov = v. slither, wriggle, squirm, writhe
ngoy' = v. be responsible
ngo' = v. be old (not new)
ngub = v. migrate, immigrate, emigrate
nguD = v. be glued to
nguH = v. testify
nguHwI' = n. witness (in court)
ngun = v. perch
ngup = n. cape (clothing)
ngup = n. authority, power, one in authority or in charge
ngup'a' = n. The Dominion
nguq = v. be arrogant, be haughty, be conceited
ngur = v. be autistic
ngutlh nagh = n. die, dice with letters
ngutlh tu'qom = n. font, typeface
nguv = v. be dyed, be stained, be tinted
nguvmoH = v. dye, stain, tint
nguy = v. scoff
ngu' = v. identify
pab = v. follow (rules)
pabHa' = v. misfollow [the rules], follow [the rules] wrongly
pab = n. grammar
pab buv = n. part of speech
pach = n. claw, talon
pach moQ = n. high court gavel
pagh = n. nothing, none, no one
pagh = n. zero
paghDIch = n. zeroth
paghur = n. hermit, recluse
paH bID = n. skirt
paj = v. resign
pal'ar = n. kinsperson, family member
pan = v. spark, emit sparks
pan = v. solve
pang = v. pluck (a stringed instrument)
paq = n. book
paq = n. Pok
paq Duj = n. bookmobile
paq nojwI' = n. librarian
paq nojwI' qach = n. library (building)
paq nojwI' tum = n. library (public)
paq 'ay'mey = n. contents, table of contents (of a book)
paq'batlh = n. Book of Honor
paQ = v. meditate (on), cogitate (about), reflect (on), contemplate
par = v. dislike
parbIng = n. a mid-sized bird with particularly garish coloring (at least from a Klingon point of view)
pargh = v. be synthetic, be artificial
parHa' = v. like
parmaqqay = n. romantic companion, romantic partner
parmaq qep = n. date
paS = v. be late
paSlogh = n. socks
paSlogh tuQ DaS = be inside-out
pat = n. system
patlh = v. be ranked, have a status, be graded, be sorted
patlhmoH = v. rank, assign status, sort, compare
pav = v. be urgent
paw = v. arrive
paw' = v. collide
paw' = v. butt heads
paw'aD = n. vein
pay = v. regret
pa' = n. room, enclosed area, chamber
pa' = n. there, over there, thereabouts
pa' jIHpu'be'. = I wasn't there.
pa'vo = n. Pahvo
pa'vongan = n. Pahvan
pa'vo' yIjaH! = Leave the room!
pe- = v. imperative: you (plural)-none
peb'ot = n. type of fruit
peD = v. snow, fall slowly (like snow)
pegh = v. keep something secret
pegh = v. be secret
pegh = n. secret
peghmey vIttlhegh = n. secrecy proverb
peHghep = n. Age of Inclusion
pej = v. demolish
pel'aQ = n. shell (of an egg)
pel'aQ = n. coffin
pel'aQDaj ghorpa' = before it's too late
pentatlh wej = n. Pentath III
peng = n. torpedo
peng baHjan tuj ghImwI' = n. heat exhaust for torpedo launcher
pep = v. raise
peq = v. slaughter
per = v. label, ascertain, specify
per yuD = n. code name
peS = v. supply, furnish, provide, dispense
pet = v. be welded (together)
pevang! = Take action! Do it! Make it so!
pe' = v. cut
pe'meH taj = n. cutting knife
pe'meH 'echlet = n. cutting board
pe'vIl bI'chu' = to do something at once, as a single event
pe'vIl mu'qaDmey tIbach. = Curse well!
pe'vIl roS = use the third toe forcefully
pe'vIl Supaw'jaj! = Welcome!
pe''egh = v. keep score
pI- = v. we-you
pIch = v. blame
pIch vIghajbe'. = It's not my fault.
pID = v. coat (food) with herbed mixture
pID = v. {laS:v}
pIH = v. expect
pIH = v. be suspicious
pIj monchugh vay' yIvoqQo'. = Don't trust those who frequently smile.
pIj tay'taH Doch pIm = Infinite Diversity in Infinite Combinations
pIl = v. be stimulated, be inspired, be motivated
pIlHa' = v. be unmotivated
pIlmoH = v. stimulate, inspire, motivate
pIm = v. be different
pIn = n. boss
pIn = n. expert, authority
pIn tlhoy' = n. territorial wall (e.g., Berlin Wall)
pInHom = n. apron (clothing)
pIn'a' = n. master
pInaDqu' tuqlIj wInaDqu' je. = Glory to you and your House.
pIp = n. spine
pIpyuS pach = n. pipius claw (food)
pIpyuS pach DaSop DaneHchugh pIpyuS puS DaghornIS. = If you want to eat pipius claw, you'll have to break a few pipiuses.
pIpyuS yIghor! = Break a pipius!
pIqarD = n. {janluq pIqarD:n:name}
pIqcho' = n. athlete
pIqcho' qaD = n. athletic competition
pIqcho' Quj = n. athletic competition
pIQ = v. be direct
pIQHa' = v. be indirect, be roundabout, be devious
pIr = v. be fertile
pIraqSIS = n. Praxis
pIv = v. be healthy
pIvchem lIngwI' DaH = n. warp field generation array
pIvchem SeHwI' = n. warp field controller
pIvghor lIngwI' = n. warp generator
pIvghor lIngwI' DaH = n. warp generation array
pIvghor pat = n. warp drive system
pIvyoch = n. pffiots
pIw rebmugh = n. incense
pI' = v. be fat
po = n. morning
po Ha'DIbaH = n. animal that makes noise at dawn (literary name for {'uSgheb:n} or {jajlo' Qa':n})
pob = n. hair (on body)
pob yIvbeH = n. sweater
poch = v. plant
poD = v. be clipped
poDmoH = v. clip
poH = n. period of time
poH = v. time
poH qut = n. time crystal
poj = v. analyze
pol = v. keep, save
polHa' = v. discard
pollaH pagh polHa'laH = the matter is unimportant, it does not make a difference
pon = v. persuade, convince
pong = n. name
pong = v. name, call
pop 'oH ghob'e'. = Virtue is the reward.
poQ = v. demand, require
por Ho'Du' = n. rake (for leaves)
por pur = inhale leaf
porgh = n. body
porgh Hat = n. body temperature
porgh mIw = n. bodily function
porghQeD = n. scientific study of bodily functions
porghtej = n. scientist who studies bodily functions
poS = v. be open, be opened
poSmoH = v. open
potlh = v. be important
potlh De' = n. priority message
potlhbe'chugh yay qatlh pe''eghlu'? = If winning is not important, then why keep score?
pov = n. afternoon
pov = v. be excellent
poy' = v. confiscate
po' = v. be expert, be skilled
po'wI' = n. expert
po'lIgh = n. sauce (food, general term)
pub = v. boil
pubtaHbogh ghargh HIq = n. boiling worm wine
puboS = n. scapula, shoulder blade
puchpa' = n. washroom, bathroom
puH beQ = n. plains, flatland
puH Duj = n. car, land vehicle
puH nIl = n. grassland, steppe
puH taD = n. tundra
puH yIQ = n. swamp, wetlands
puj = v. be weak
puj = n. weakness
pujmoH = v. weaken
pujwI' = n. weakling
pujwI' HIvlu'chugh quvbe'lu'. = There is no honor in attacking the weak.
pul = v. be ground up
pun = v. be low (in pitch)
pum = v. accuse
pum = v. fall
pung ghap HoS. = Mercy or power.
pup = v. be perfect, be exact
pup = v. be high resolution
pup = v. kick
pupHa' = v. be approximate
pupqa' = v. bribe
puq = n. child, offspring
puq chonnaQ = n. fork
puq Hol = n. child's language, "baby talk"
puq poH = n. generation
puqbe' = n. daughter
puqloD = n. son
puqnI' = n. grandchild
puqnI'be' = n. granddaughter
puqnI'loD = n. grandson
puQ = v. be fed up
pur = v. inhale
puS = v. be few, be several, be a handful
puS = v. sight (with a gunsight)
puv = v. fly
puy = v. wreck
pu' = n. phaser
pu' = n. spike, boot spike
pu' = n. horn
pu'beH = n. phaser rifle
pu'beq = n. phaser crew
pu'DaH = n. phaser banks
pu'HIch = n. phaser pistol
pu'vengmey = n. cat's whiskers, insect antennae
qa- = v. I-you
qab = v. be bad
qab = n. face
qabDu' law' = n. many faces
qab jech = n. mask
qablIj HI'ang! = Show me your face!
qabwIj vISo'be'. = I don't hide my face.
qach = n. building, structure
qach choghvat = n. {choghvat:n:2}
qach DIS = n. basement
qach noy = n. landmark (building)
qaD = v. challenge, resist, oppose, confront, face
qaD mIr = n. tournament
qaDrav = n. challenge floor
qagh = v. interrupt
qaghwI' = n. glottal stop
qagh = n. serpent worm (as food)
qagh HoH = to do something counterproductive
qagh Sopbe'! = He doesn't eat gagh!
qagh tlhIq = n. gagh stew, gagh served as leftovers
qagh vIychorgh = n. sauce for gagh
qaH = n. sir
qaj = v. soar
qal = v. be corrupt
qalmoH = v. corrupt
qam = n. foot
qam Do Duj = n. bicycle (Terran vehicle)
qama' = n. prisoner
qamchIy = n. Qam-Chee
qamor = n. Kahmor
qan = v. be old (not young)
qan = v. use the pinkie, little finger
qanchoHpa' qoH, Hegh qoH. = Fools die young.
qanwI' = n. pinkie, little finger
qanjIt = n. Kanjit
qanQIy = n. Cancri
qanQIy loS = n. Cancri IV
qanraD = n. a bird known for its song
qanra' = n. Kahnrah
qang = v. pour (from one container into another)
qang = v. always agree with, always cooperate with
qap = v. insist
qaq = v. be preferable
qar = v. be accurate
qar'a'? = Is that so?
qara'DI' cha yIbaH! = Fire the torpedoes at my command!
qarDaS = n. Cardassia
qarDaSngan = n. Cardassian (person)
qarDaSQa' = n. Cardassian Union
qargh = v. be bulky, be thick
qarghan = n. Kargan
qaryoq = n. bird capable of mimicking speech
qaryoq'a' = n. bird capable of mimicking speech, larger than {qaryoq:n}
qaS = v. occur, happen
qaStaHvIS wa' ram loS SaD Hugh SIjlaH qetbogh loD. = Four thousand throats may be cut in one night by a running man.
qaStaHvIS wej puq poHmey vav puqloDpu' puqloDpu'chaj je quvHa'moH vav quvHa'ghach. = The dishonor of the father dishonors his sons and their sons for three generations.
qaSuj'a'? = Am I disturbing you?
qat = v. wrap, encase
qat = v. accompany (singing) with instrumental music
qatru' = n. nerd
qatvoH = n. shellfish (clam, oyster, mussel, scallop, brachiopod, etc.)
qav'ap juH = n. apartment
qaw = v. remember
qawHa' = v. misremember, remember incorrectly
qawmoH = v. remind
qaw' = v. tip over, flip over
qaw'moH = v. tip over, knock over, knock down
qay = v. use the second (middle) finger
qaywI' = n. middle finger, second finger
qayrI'Hom = n. clavicle
qaytu' = n. parent (gender-neutral term)
qay' = v. be a problem, be a hassle
qay'be' = No problem.
qa' = v. replace
qa' = n. spirit
qa' wIje'meH maSuv. = We fight to enrich the spirit.
qa'meH vIttlhegh = n. replacement proverb
qa'meH mI' = n. version number (minor)
qa'mInar = n. Kaminar
qa'put = n. monkey-like creature
qa'raj = n. type of animal, ka'raj
qa'rol = n. a really big bird
qeb = v. squeeze (windbag instrument)
qech = n. idea
qeD = v. vacate
qeH = v. resent
qeHHa' = v. forgive, unresent
qej = v. be grouchy, be mean
qel = v. consider, take into account
qel = v. nod
qelpIngan = n. Kelpien
qelpIya'ngan = n. {qelpIngan:n}
qem = v. bring
qempa' = n. ancestor, forebearer (cultural or societal)
qempa'QeH = n. Qempa'keh, the Warriors of the Dead
qen = v. wipe
qeng = v. carry, convey
qeng = n. Kang
qep = n. meeting
qepHom'a' = n. annual meeting of Klingon speakers in Germany
qep'a' = n. KLI annual conference
qeq = v. practice, train, prepare
qer = v. shrink (get smaller)
qerHa' = v. un-shrink (grow back to original size)
qeS = n. advice
qeS = v. advise
qeS'a' = n. The Klingon Art of War
qeSHoS = n. fox
qeSnoDmaj = n. jellyfish
qet = v. run, jog
qettlhup = n. type of sauce
qetlh = v. be dull, be uninteresting
qev = v. crowd
qevaS = n. kevas (a traded commodity)
qevpob = n. jowl, cheek
qew = v. use the ring (third) finger
qewwI' = n. ring finger, third finger
qey = v. be in vain, be futile
qey'Hav = n. vagina
qeylar = n. K'Ehleyr
qeylIS'e' lIjlaHbe'bogh vay' = n. Kahless the Unforgettable
qeylIS = n. {qeylIS'e' lIjlaHbe'bogh vay':n:name}
qeylIS betleH = n. Sword of Kahless
qeylIS bov = n. the era of Kahless
qeylIS bov nubwI' = n. before the era of Kahless
qeylIS mInDu' = n. Eyes of Kahless, a game played with dice
qeyvaq = n. Kayvak
qeyvaq Ha'DIbaH = n. Kayvak's food
qIch = v. condemn
qID = v. joke, make a joke, tell a joke
qIH = v. meet (for the first time)
qIj = v. be black
qIj 'ej wov = gray
qIl = v. cancel; abort (a computer program)
qIm = v. pay attention, concentrate
qImHa' = v. disregard
qImlaq = n. K'mlak
qIn = v. moan, groan
qInlat = n. Quin'lat
qIp = v. hit (with hand, fist, implement)
qIQ = v. mutiny
qIrq = n. {jemS tIy qIrq:n:name}
qIS = v. be libidinous
qISa'ruj = n. Raptor (vessel)
qIt = v. be possible
qIt = n. a kind of bird
qItI'nga' = n. K'Tinga class (vessel)
qItoy = n. prostitute
qIv = n. knee
qIvon = n. body part (not further identified)
qIvon belmoH = to go to the bathroom
qIvo'rIt = n. K'Vort class (vessel)
qI' = v. sign (a treaty)
qI' = v. register for, sign up for (an account)
qI'empeq = n. K'mpec
qoch = n. partner
qoch = v. squeeze (into a space)
qoD QutlhwI' ngaDmoHwI' = n. inner support stabilizer
qogh = n. belt
qogh = n. ear (external, cartilaginous flap)
qogh tuQmoHHa' = to not hear
qoH = n. fool
qoH vuvbe' SuS. = The wind does not respect a fool.
qol = v. pronounce
qol = n. collection of segments that are joined together, collocation
qol = n. Kol
qolotlh = n. Koloth
qompogh = n. type of food
qon = v. record, compose
qonwI' = n. songwriter
qongmeS = n. sibling
qop = v. arrest
qoq De'wI' Dojmey = n. botnet (computer jargon)
qor = v. scavenge
qor = n. Kor
qor tuq = n. House of Kor
qorDu' = n. family
qoreQ = n. Korax
qorgh = v. stop up, fill a hole
qorghwI' = n. cork, pacifier
qortar = n. Kortar
qorvaq = n. Qorvaqk
qorvIt = n. korvit, type of rodent
qoS = n. birthday
qoSqa'rIy = n. Kos'Karii (a group of mythological creatures)
qot = v. back, sponsor, support, capitalize, invest in
qotlh = v. tickle
qotlh = v. deserve, warrant
qovIj = n. small canine-like creature
qoy' = v. plead, beg
qo'la' 'awje' = n. cola (soft drink)
qo'leq = n. Ko'lek
qo'rIDan = n. Coridan
qo'rIn DIr = n. leather
qo' Sor = n. the Great Tree of the World
qub = v. be rare
quch = v. kidnap
quD = n. type of sauce
qugh = v. cruise
quH = v. slice, carve
qul = n. fire
qulHom = n. spark
qulHuD = n. volcano
qul DIr = n. fire skin (food)
qul DIr yISop! = Hurry up! Move quickly!
qul mI'wI' = n. fire dancer
qul naj = n. The Dream of the Fire (famous novel)
qul naQ = n. match
qul ngeng = n. lava-filled area inside a volcano
qul qaDwI' = n. fire challenger (someone who puts out fires)
qul QongmoHwI' = n. someone who puts out fires (usually not applied until the fire is out)
qul SuvwI' = n. fire warrior, fire fighter (someone who puts out fires)
qul tuq = n. House of Fire (name of an opera)
qul tlhay'moHwI' = n. fire tamer (a less common term for someone who puts out fires)
qul 'alwI' = n. will-o'-the-wisp
qum = v. govern
qumwI' = n. governor
qum DuSaQ = n. public school
qun = n. history
qun = v. scold
qun qon charghwI'pu''e'. = History is written by the victors.
qunQeD = n. history science
quntej = n. historian
qup = n. elder
qup'a' = n. patriarch, matriarch
quprIp = n. Council of Elders
quq = v. happen simultaneously
qur = v. be greedy
qurbuSwI' = n. architect (Morskan)
qurgh = n. bean, beans
qurleH = n. kur'leth (type of weapon; similar to but longer than mek'leth)
qurmoQ = n. larynx
quS = n. chair
quSDaq ba' = that's obvious
quSDaq ba'lu''a'? = Is this seat taken?
qut na' = n. salt (culinary, halite)
qut = v. predict
qutluch = n. kut'luch, type of hand weapon
qutluch patlh = n. hierarchical structure
qutluch tay = n. Kut'luch Ceremony
qutlh = v. be cheap
quv = n. honor
quv = v. be honored, be honorable
quvHa' = v. be dishonored
quvHa'ghach = n. dishonor
quvHa'ghach mIr = n. losing streak
quvmoH = v. honor
quv bey' = n. Honor Display (type of ceremonial weapons display)
quv Hutlh HoHbogh tlhIngan 'ach qabDaj 'angbe'bogh. = The Klingon who kills without showing his face has no honor.
quwargh = n. Quark
qu' = v. be fierce
qu' = v. be great, be wonderful, be excellent, be splendid
qu'rIl wa' = n. Kurill Prime
qu'vIgh = n. member of an august body
Qa = v. grow (increase in size)
QaHa' = v. un-grow (shrink back to original size)
Qach = v. wield or swing (a weapon)
QaD = v. be dry, be dried out
QaD = v. be safe, be protected
QaDmoHwI' DIr = n. towel
Qagh = v. err, be mistaken, make a mistake
QaghmeylIj tIchID, yIyoH. = Have the courage to admit your mistakes.
QaH = v. help, aid
Qaj = n. type of animal, kradge
Qaj tlhuQ = n. type of food, kradge tail
Qal = v. swim
QalmeH DoQmIv'a' = n. swimming pool
Qam = v. stand
QamvIS Hegh qaq law' torvIS yIn qaq puS. = Better to die on our feet than live on our knees.
Qan = v. protect
Qang = n. chancellor
Qap = v. work, function, succeed, win
Qap = v. operate, be in operation
Qap tlham. = Gravity works.
Qapchu'meH chuq = n. effective range
QapwI' mIr = n. winning streak
Qapla' = n. success
Qapla'! = Success!
Qaq = v. behave falsely honorably, behave in a falsely honorable manner
QaQ = v. be good
QaS = n. troops, troop member
QaS = n. Kras
Qat = v. be popular
Qatlh = v. be difficult, be complex
Qav = v. be final, be last
Qaw = v. rub
Qaw' = v. destroy
Qay = v. transfer
Qay' = v. blow one's top, lose one's temper
Qay' = v. use the little toe
Qay'wI' = n. little toe, fifth toe
Qay'mol teSra' = n. puzzle piece
Qa' = n. type of animal
Qa'Da' = n. type of animal, krada
Qa'Hom = n. type of animal (cowardly animal similar to {Qa':n:1} but smaller, mistaken for a bird by some)
Qa'raj = n. {qa'raj:n}
Qa'taq = n. K'Ratak
Qeb = n. ring (for finger)
Qeb = n. ponytail holder
Qechjem'a' = n. trunk (of tree)
QeD = n. science
QeD pat = n. science system
QeD SeHlaw = n. science console
QeDpIn = n. science officer
QeH = v. be angry, be mad
Qej = v. cherish, value
Qel = n. doctor, physician
Qel = n. Krell
Qem = v. sheathe, holster
Qen = v. be naked, be nude
Qep = v. be anxious (about)
Qeq = v. aim (at)
Qeq = v. face (orient towards)
Qev = v. stew
Qey = v. be tight
QeyHa' = v. be loose
QeyHa'moH = v. loosen
QeymoH = v. tighten
Qey' = v. be cool (temperature)
Qe' = n. restaurant
Qe' much = n. cabaret (show)
QIb = v. filter, strain, sieve, sift
QIch wab = n. speech sound, phoneme
QIch wab Ho'DoS = n. pronunciation
QIch wab Ho'DoS Sar = n. accent
QIch wab Sar = n. allophone
QID = v. wound
QIH = v. damage, cause damage
QIH = v. wrong, treat unjustly
QIj = v. explain
QIl = v. be desperate
QImHal = n. ovary
QIm julHom = n. {Sotlhqel:n}
QIn = v. inject
QIn = n. message
QIn = n. spearhead
QIn pup = n. plain spearhead with single sharp point
QIn tum = n. postal service
QIn tum qach = n. post office (building)
QIn vagh = n. spearhead with multiple points
QIn 'echletHom = n. postcard
QIncha' = n. krencha, type of animal (reptilian)
QIngheb = n. type of spear
QIp = v. be stupid
QIq = v. draw (as a weapon)
QIS = v. stitch, sew
QIStaq = n. Kri'stak
QIv = v. be inferior
QI'lop = n. holiday (name of a specific holiday)
QI'tomer = n. Khitomer
QI'tomerDaq Heghpu' Hoch. = No one survived Khitomer.
QI'tu' = n. Paradise (source of creation in Klingon mythology)
QI'yoS wa' = n. Krios Prime
Qob = v. be dangerous
Qob = n. danger
Qoch = v. disagree
Qochbe' = v. agree
QoD = v. maneuver (engines)
Qogh = n. type of animal
QoghIj = n. brain (organ)
Qoghogh = v. snort
QoH = v. tap
Qoj = v. make war
Qol = v. beam away
Qom = v. experience an earthquake or tremor
Qom = v. be hazardous, be perilous, be treacherous
Qong = v. sleep
QongmoH = v. put to sleep, cause to sleep
QongmoH = v. extinguish (a fire)
QongDaqDaq Qotbe' tlhInganpu'. = Klingons do not lie in bed.
QongDaq buq = n. pillow, sleeping bag, "bed pouch"
QongDaq 'echlet tun = n. mattress (non-Klingon concept)
Qop = v. be worn out
Qop = v. be dead (referring to food)
QopmoH = v. wear out
QoQ ghom = n. music group
QoQ jan = n. musical instrument
QoQ ngutlh = n. musical note (glyph or character)
Qor = v. fight, battle (very minor fight)
Qorgh = v. take care of, care for
QoS = v. be sorry
Qot = v. lie, recline
QotDI' gheD tlhejbe' wamwI'. = The hunter does not lie down with the prey.
Qotmagh = n. Krotmag
Qotmagh Sep = n. Krotmag region
Qotlh = v. disable
Qoy = v. hear, listen to
QoymoH = v. let someone hear (something)
Qoylu'taH = the clock is ticking
Qoy' = v. spill
Qo'noS = n. Kronos
Qu = v. cast (cast metal)
QumeH ngaSwI' = n. mold (for casting)
Qub = v. think
Quch = v. be happy
Quch = n. forehead
QuchHa' = v. be unhappy
Qugh = n. disaster
Qugh = n. Kruge
Quj = v. play a game
QujmeH moQ = n. ball
QujwI' lIw = n. play token, game piece
Quj 'echlet = n. game board
Qul = v. research
Qum = v. communicate
Qum = n. communications, communications-related technology
Qum De'wI' = n. communications computer
Qum pat = n. communication system
Qum SeHlaw = n. communications console
QumpIn = n. communications officer
QumwI' = n. communicator, communications device
QumwI'wIj vItu'laHbe'. = I can't find my communicator.
Qun = n. god, supernatural being
Qung = v. be rounded, blunt
Qup = v. be young
Qur = n. structure, organization (the way things fit together; the arrangement of the parts of something bigger)
Qur = n. anatomy (referring to animals)
QuS = v. conspire
Qut = v. be vulgar
Qutlh = v. support (physically)
QuvlIjDaq yIH tu'be'lu'jaj! = May your coordinates be free of tribbles!
Qu' = n. duty, quest, mission, task, chore
Qu'Hom = n. errand
Qu' buSHa'chugh SuvwI', batlhHa' vangchugh, qoj matlhHa'chugh, pagh ghaH SuvwI''e'. = If a warrior ignores duty, acts dishonorably, or is disloyal, he is nothing.
Qu' DataghDI' 'aqtu' mellota' je tIqaw. = When you begin a mission, remember Aktuh and Melota.
Qu' poH = n. shift, work shift
Qu' vu'wI' yaH = n. Mission Ops
Qu'Daj ta'taHvIS Hegh 'e' tul Hoch tlhIngan. = To die in the line of duty is the hope of every Klingon.
rab = v. be gigantic, be huge, be humongous
rach = v. invigorate, fortify, strengthen
rachwI' = n. nurse
raD = v. force, compel
ragh = v. decay, rust, corrode
raHta' = n. type of food, racht
rajma' = n. kidney
ral = v. be violent
ram = v. be trivial, be trifling, be unimportant, be insignificant
ram = n. night
ram meqmey. = Motives are insignificant.
ramjep = n. midnight
ramjep = n. ramjep bird (sometimes served as food)
ramDung = n. gum (chewing gum)
rang = v. be responsible for
rap = v. be the same
raq = v. be repetitive, be redundant
raQ = v. manipulate by hand, handle
raQpo' = n. passenger
rar = v. connect
rarchuq = v. be related
rarwI' = n. connector, plug
raS De'wI' = n. desktop computer, stationary computer
ratlh = v. remain
rav = n. floor
rav = n. minimum
raw = v. lightning
raw' = n. an aquatic bird with colorful plumage
raytej = n. geneticist
ray' = n. targets
ra' = v. order, command
ra' = v. conduct (an orchestra)
ra'Duch puj = n. scalene triangle
ra'Duch quv = n. isosceles triangle
ra'Duch tIQ = n. equilateral triangle
ra'ghom = n. command group, command staff
ra'ghomquv = n. High Command
ra'wI' = n. commander (any officer of rank {Sogh:n:nolink} or higher)
ra'wI' lupwI' = n. taxi
re- = v. we-you (plural)
rech = v. exhale
reD = n. exterior wall
reD = n. side (geometry)
reD = n. side (exterior surface)
regh = v. bleed
reghuluS = n. Regulus
reghuluS chorgh = n. M-113, Regulus VIII
reghuluS 'Iw HIq = n. Regulan blood wine
reghuluS 'Iwghargh = n. Regulan bloodworm
reghuluSngan = n. Regulan
reH = v. play
reH bang larghlu'. = Love is always smelled.
reH boch qutluch lo'lu'bogh. = The used kut'luch is always shiny.
reH DuSIgh vavlI'. = Your father is a part of you always.
reH Hegh yoHwI'pu''e'. = Always it is the brave ones who die.
reH HIvje'lIjDaq 'Iwghargh Datu'jaj! = May you always find a bloodworm in your glass!
reH latlh qabDaq qul tuj law' Hoch tuj puS. = The fire is always hotter on someone else's face.
reH lugh charghwI'. = The victor is always right.
reH nuHmey tu'lu'. = There are always weapons.
reH Suvrup tlhIngan SuvwI'. = A Klingon warrior is always prepared to fight.
reH Suvrup SuvwI''a'. = A great warrior is always prepared.
reH tay' ghot tuqDaj je. = One is always of his tribe.
reH tlhIngan wo' taHjaj. = May the Klingon Empire continue forever.
reH tlhInganpu' taHjaj! = Klingons forever!
reH 'eb tu'lu'. = There is always a chance.
reH 'uQvam vIqawtaH. = I will remember this dinner forever.
rej'aq = n. Rejac
rel = v. be dazed, be delusional
rem = v. suck (e.g., through straw)
remloS = n. internal organ, entrail
rem'ay' = n. diaphragm, thoracic diaphragm
ren = v. design, map out, plan
renwI' = n. designer, architect
renyarDaq QeD = n. parapsychology
rep = n. hour
repnuj = n. gum (oral anatomy)
reqwer = n. shrimp-like creature, a type of animal
reS = v. conjure, cast (a spell)
reS = v. grow (e.g., flowers, plant, vegetables)
reStav = n. shin, forearm (outer side)
ret = v. be most recent
retlh = n. area beside, area next to
rev = v. quote
rewbe' = n. citizen
rewve' mIjDang = n. {SuS mIjDang:n}
rey = v. squeeze and stretch out (windbag instrument)
re'chIv = n. organ, internal organ
rIb = v. be spread, be spread out
rIch = v. talk about, discuss
rID = v. digest
rIgh = v. be lame
rIH = v. energize
rIHwI' = n. energizer
rIj = v. be moored, be anchored
rIjHa' = v. be adrift
rIjmeH tlhegh = n. tether, leash
rIjwI' = n. {rIjmeH tlhegh:n}
rIl = v. use the thumb (child)
rIl = v. play (a wind instrument)
rIlwI' = n. thumb (child)
rIn = v. be accomplished, be finished
rIntaH = v. fait accompli
rIq = v. pioneer, break through, innovate
rIQ = v. be injured
rIQmoH = v. injure
rIS = v. make a cracking, snapping, or clicking sound; emit a signal (could be sound, radiation, smell, etc.)
rIt = v. summon
rItlh naQ = n. pigment stick
rItlh vol = n. stencil
rItlh 'echlet = n. ink pad
rIv = v. split
rIymuS = n. Remus
rI' = v. hail (communication)
rI'meH wovmoHwI' = n. beacon
rI'wI' = n. loudspeaker
rI'gheS = n. deflector
ro = n. trunk (of body), torso
rober jan = n. lathe
roDSon = n. uvula
rogh = v. ferment
roghmoH = v. cause to ferment
roj = v. make peace
roj = n. peace
rojHom = n. truce
rojmab = n. peace treaty
rojmab qep = n. peace talks
rol = n. beard
rol taj = n. razor
romuluS = n. Romulus
romuluS HIq = n. Romulan ale
romuluSngan = n. Romulan
romuluSngan Sambogh 'ej HoHbogh nejwI' = n. Romulan hunter-killer probe
ron = v. roll, be rolling
ron = v. roll (aircraft wings tilt, one up, one down)
rong = v. roast, grill, broil
rop = v. be sick, be ill
rop'a' = n. plague, major disease
ropchoHbe' tlhInganpu'. = Klingons do not get sick.
ropyaH = n. infirmary
ropyaH qach = n. hospital
ropyaH yIghuHmoH! = Alert sick bay!
roQ = v. put down
ror = v. be fat (not lean)
rorgh = v. be fantasy
roS = v. lick
roS = v. use the third toe
roSbe' = v. be libidinous
roSHa'moH = v. paralyze
roSwI' = n. third toe
roSqa'QeD = n. archaeology
roSqa'tej = n. archaeologst
rotlh = v. be tough
ro' = n. fist
ro'lIj HI'ang! = Show me your fist!
ro' mojchugh ghIt = idiomatic phrase which expresses contrast
ro'qa' = n. tonsil
ro'qegh'Iwchab = n. rokeg blood pie
rubyo' = n. politician
ruch = v. proceed, go ahead, do it
ruDelya' = n. Rudellia
ruDelya' rop'a' = n. Rudellian plague
rugh bIQSIp = n. anti-hydrogen
rugh tem = n. positron
ruH = v. blush
ruj = v. be physical (subject to laws of physics)
run = v. be short (in stature)
rup = v. fine, tax
ruq = v. belch, fart
ruqwI' = n. {Senjorgh:n}
ruq'e'vet = n. Ruk'evet city
ruQ = v. control manually, by hand
rur = v. resemble
rura' pente' = n. Rura Penthe
rura' pente'Daq chuch ngevlaH ghaH. = He can sell ice on Rura Penthe.
ruryuD = n. rhinoceros-like creature, a type of animal
ruS = v. be positively charged, have a positive charge
ruStay = n. bonding ritual
ruSvep = n. invitation
rut yIHmey ghom Hoch. = Everyone encounters tribbles occasionally.
rutlhHom = n. mouse wheel (computer device)
rutlh 'echlet = n. skateboard (Terran sports equipment)
rutlh = v. be round
ruv nay' = n. dessert
ru' = v. be temporary
ru' = v. be ready to collapse or die (referring to food)
ru'Ha' = v. be permanent
Sa- = v. I-you (plural)
Sa = v. rhyme with
Sab = v. decline, deterioriate
Sach = v. expand
Sach = v. be amplified, be fleshed out, be elaborated, be increased in scope, etc.
SaD = n. thousand (number-forming element)
SaDbIp = n. hundred million (number-forming element)
SaDSaghan = n. trillion (number-forming element)
SaD DIS poH = n. millennium
Sagh = v. be serious
Saghan = n. billion (number-forming element)
SaH = v. be present (not absent)
SaH = v. care (about), be concerned (about)
SaHHa' = v. be unconcerned (about)
Saj = n. pet
Sal = v. ascend
Sam = v. locate, seek and find
SanID = n. {SaD:n:num}
SanIDbIp = n. hundred million (number-forming element)
SanIDSaghan = n. trillion (number-forming element)
SanmIr QuQ = n. spore drive
Santay = n. zantai (rank)
Sang = v. obliterate
Sap = v. volunteer
Saq = v. land (alight on the ground, like a bird)
SaqSub = n. Saq'sub (home region of Kahless)
SaQ = v. cry
Sar = v. be varied, be various
Sargh = n. sark, type of animal (horse-like Klingon animal)
SaS = v. be horizontal
SaS = v. be shallow, be superficial, be uncritical, be unfortunate, be not good
Sat = v. be stuck (in a situation)
Saw = v. marry (husband does this)
Saw' = v. have a depth of
Say' = v. be clean
Say'moHmeH DoQmIv'a' = n. bathtub
Say'moHwI' tlhagh = n. soap
Say'qu' = v. be sterile (very clean)
Say'qu'moH = v. sterilize
Sa' = n. general (rank)
Sa'Hut = n. buttocks, rear end
Sa'Hut = n. back (exterior surface)
Sa'Qej Sep = n. Sakrej region
Sech qengwI' = n. Torchbearer
SeD = v. drive (a land vehicle)
SeH = v. control
SeHwI' pat = n. control system
Sen = v. use the thumb (adult)
SenwI' = n. thumb (adult)
SenwI' rIlwI' je = n. everybody
Sen = v. scoff
SenDeq = n. twin
Senjorgh = n. grenade
Senjo' = n. Shenzhou
Senjaw = n. {Senjo':n:name}
Seng = v. cause trouble
Seng = n. trouble
Sep = v. breed
Sep = v. exponentiate
Sep Hol Sar = n. regional dialect
SeQ = v. be formal, be ritualistic, be ceremonial
SermanyuQ = n. Sherman's Planet
SeS ghItwI' = n. geyser (steam)
Sev = v. contain (an enemy)
Sey = v. be excited
SeymoH = v. excite
SeymoH QeH. = Anger excites.
Se' HablI' = n. radio
Se' lISwI' = n. frequency conditioner
Se' lISwI' yIb = n. frequency conditioner inlet
Se'vIr malja' = n. publishing house
SIch = v. reach
SID = n. patient
SIgh = v. influence
SIH = v. bend, be bent
SIHHa'moH = v. solve
SIj = v. slit
SIj = v. be insightful, be clever
SIjwI' = n. type of knife (used for food preparation)
SIl = v. divert
SIlwI' tat noch = n. diverter ion sensor
SIlreq = n. Silrek
SIm = v. calculate
SIp = n. gas
SIpoq = n. Spock
SIq = v. use the index finger
SIqwI' = n. index finger, first finger
SIqnaSwaq = n. elf, gnome
SIqral = n. {SIqral bIQtIq:n}
SIqral bIQtIq = n. the River Skral
SIQ = v. endure, bear
SIQwI' = n. celebrant, recipient
SIQab'el = n. Scrabble
SIr = v. be unique, be unprecedented
SIrgh raghghan = n. puppet (marionette)
SIrgh 'aplom = n. bead
SIrgh 'o'lav = n. snare drum
SIrHugh = n. buffoon, laughingstock
SIrHagh = n. {SIrHugh:n}
SIS = v. rain
SIv = v. wonder
Soch = n. seven
SochDIch = n. seventh
SochmaH = n. seventy
Soch = n. seventh tone of nonatonic musical scale
SoD = v. flood
Sogh = n. lieutenant
SoH = n. you
SoHDaq qeylIS qa' yInjaj. = May the spirit of Kahless live within you.
SoH 'Iv? = Who are you?
Soj = n. food, drink
Soj = n. matter, concern, affair
Soj choHwI' = n. food replicator
Soj chuv = n. leftover food
Soj naQ = n. chopstick
Soj polmeH pa' = n. food storage
Soj qub = n. haute cuisine
Soj tetlh = n. grocery list
Soj tlhol = n. raw, unprocessed food
Soj vutlu'pu'bogh = n. food that has been prepared
Soj yIDIl! = Pay for the food!
Sol = v. quarrel
SolbIS = n. whale, dolphin, porpoise
Somraw = n. muscle
Son = v. relieve (stress, pain)
SonchIy = n. death ritual (for a leader)
Sop = v. eat
SopmeH pa' = n. dining room, eating room
SoQ = v. be closed, be shut
SoQmoH = v. close, shut
Sor = n. tree
Sor = v. speak non-metaphorically
SorHa' = v. speak metaphorically
Sor DIr = n. bark (of a tree)
Sor Hap = n. wood
Sor Hap 'In = n. wood drum
Sorgh = v. sabotage
Sorya' = n. Sauria
Sorya' HIq = n. Saurian brandy
SoS = n. mother
SoSoy = n. mommy
SoS taj = n. mother's knife
SoSnI' = n. grandmother
Sot = v. be distressed, be in distress
Sov = v. know
Soy' = v. be clumsy
Soy' = v. be messy
So' = v. hide, cloak
So' = v. encrypt
So'chem tlhuDwI' = n. cloaking field emitter
So'chem tlhuDwI' jIHwI' = n. cloaking field emitter monitor
So'Ha' = v. unhide, decloak
So'Ha' = v. decrypt
So'wI' = n. cloaking device
So'wI' DaH = n. cloak array
So'wI' yIchu'! = Engage the cloaking device!
So'wI' yIchu'Ha'! = Disengage the cloaking device!
So'chIm = n. "soh-chim", surrogate parent, godparent
Su- = v. you (plural)-none
Sub = v. be solid
Sub = v. be brave, be heroic, be bold, be valiant, be intrepid
Sub = n. hero
Subpu' vaS = n. Hall of Heroes
Such = v. visit
SuD = v. be green, be blue, be yellow
SuD = v. gamble, take a chance, take a risk
SuD veqlargh mInDu'. = Somebody is jealous.
Sugh = v. install (in office)
Suj = v. disturb
Sum = v. be near, be nearby
Sung = n. native
Sup = v. jump
Sup = n. resource
Suq = v. acquire, obtain, get
Suqqa' = v. prepare {quD:n} in a specific way
SuQ = v. be toxic
Surgh = v. skin
SuS = n. wind, breeze
SuS = v. blow (into wind instrument) to produce sound
SuS mIjDang = n. fan, handheld fan
Sut DeSwar = n. wardrobe, clothing closet
Sut HabmoHwI' = n. iron (clothing iron)
Sut veragh = n. button (clothing)
Sutay = n. sutai (rank)
Suto'vo'qor = n. Sto-Vo-Kor
Sutlh = v. negotiate
Sutlhne' = n. amateur
Suv = v. fight
Suvbe'chugh SuvwI' tlhuHbe' SuvwI'. = If a warrior does not fight, he does not breathe.
Suvchu' = v. fight to the death
Suvlu'taHvIS yapbe' HoS neH. = Brute strength is not the most important asset in a fight.
SuvmeH 'ej charghmeH bogh tlhInganpu'. = Klingons are born to fight and to conquer.
SuvwI' = n. warrior
SuvwI'pu' qan tu'lu'be'. = There are no old warriors.
Suy = n. merchant
SuyDuj = n. merchant ship
Suy' = n. type of animal, shooy
Su'lop = n. type of food
Su'roq wa'DIch = n. ground floor
Su'wan ghew = n. butterfly
tay = n. the consonant {t:sen:nolink}
tab = v. wane, ebb, dwindle
tabHa' = v. wax (increase)
tach = n. bar, saloon, cocktail lounge
tachDaq maghom. = We will meet in the cocktail lounge.
tach = v. turn over
taD = v. be frozen
taDmoH = v. freeze
taD = n. taD (name of planet)
tagh = n. lung
tagh = v. begin a process, initiate (proceedings)
taH = v. continue, go on, endure, survive
taH = v. be at a negative angle
taH pagh taHbe'. = To be or not to be.
taj = n. knife, dagger
taj Hol = n. propaganda
tajHom = n. extra blade on a d'k tahg
tajtIq = n. type of knife (long blade)
tajvaj = n. angle
tajvaj = n. corner of a room
tajvajHom = n. acute angle
tajvaj'a' = n. obtuse angle
tajvaj leD = n. right angle
tal = n. cannon
tal jo' = n. cannon machinery
tal QanwI' = n. cannon guard
tal SeHwI' nguSDI' = n. cannon control motor
talarngan = n. Talarian (person)
tam = v. be quiet
tam = v. exchange, substitute
tamey ngo' = n. archives
tammoH = v. silence
tamlerQeD = n. chemistry
tamlertej = n. chemist (scientist)
tang = v. trip, stumble
tangqa' = n. a bull-like animal, type of animal
tap = v. mash, squash
tapqej = n. cherry
taq = v. be scarred
taqmoH = v. scar
taq'ev Sep = n. Tak'ev region
taQ = v. be weird
taQbang = n. exhaust
taQbang = n. urine, fecal matter
tarDIghaD = n. tardigrade
targh = n. targ
targh tIq = n. heart of targ (a food item)
targhlIj yIngagh, yIruch! = Go mate with your targ!
targhlIj yab tIn law' no'lI' Hoch yabDu' tIn puS! = Your targ has a bigger brain than all your ancestors put together!
targhoroj = n. crab
tat taS = n. electrolyte
tatlh = v. return (something)
tatlh'egh = v. return (oneself)
tav = v. shake
tav neH = tinker
tavwI' = n. amateur
taw 'ay' = n. block (city block)
tawI'yan = n. Tawi'Yan (the "best man" at a Klingon wedding)
tawleHnu' pogh = n. {tawleHnu':n}
taw' = v. be ridgy, be embossed
tay = v. be civilized
tay = n. ceremony, rite, ritual
tay = n. tai (rank)
taymoH = v. civilize
tay' = v. be together
tay'ghoqor = n. Ty'Gokor
tay'taHbe' 'Iw bIQ je. = Blood and water don't mix.
ta' = v. accomplish
ta' = n. deed, accomplishment
ta' = n. emperor
ta' Hol = n. standard dialect
ta' tlhIngan Hol = n. the Emperor's Klingon
ta'mey Dun, bommey Dun. = Great deeds, great songs.
teb = v. fill
tebwI' = n. food server in a Dok'e (fast-food restaurant)
teghbat = n. type of animal, teg'bat
teH = v. be true
tej = n. scientist
tel = n. wing
tel SeHwI' jo' = n. wing control mechanism
tel vID'Ir = n. wing baffle
telDaq wovmoHwI' = n. wing light
tellar wa' = n. Tellar Prime
tellarngan = n. Tellarite
telun Hovtay' = n. Tellun Star System
telya' = n. pancreas
tel'em = n. mentor
tem = v. deny
ten = v. embark
tennuS = n. uncle (father's brother)
tennuSnal = n. uncle (father's sister's husband)
tep jolpat = n. cargo transporter
teq = v. remove, take off
tera' = n. Earth
tera'ngan = n. Terran, Earther
tera' bIQ lung'a' = n. alligator, crocodile
tera' chuch mIl'oD = n. polar bear
tera' ghIch rop = n. common cold
tera' majaj tIy = n. kale (Terran vegetable)
tera' majajHom = n. Brussels sprouts (Terran vegetable)
tera' nagh DIr charwI' = n. snail
tera' na'ran = n. orange (fruit)
tera' na'ran'a' = n. grapefruit
tera' na'ran chang = n. marmalade
tera' na'ran HuH = n. marmalade
tera' na'ran wIb = n. lemon
tera' peb'ot = n. cucumber
tera' poH = n. Earth date, Earth time
tera' raS'IS moQ naH = n. pomegranate
tera' tlhuH rop = n. common cold
tera' yav 'atlhqam = n. mushroom
tera' 'arDeH = n. ivy (Terran)
tera' 'InSong majaj = n. cauliflower (Terran vegetable)
tera' 'oQqar qIj = n. licorice (Terran candy)
teS = n. ear (internal organ of hearing)
teS HablI' = n. earpiece
tet = v. melt (something)
tetyub = n. enamel, coating
tetlh = v. roll (down a hill like a log)
tey = v. scrape
tey = v. be uncomfortable, be close, not have wiggle room or leeway
teybe' = v. be comfortable, be not close, have wiggle room or leeway
teywI' = n. file (tool)
teywI' 'echlet = n. chalkboard, whiteboard, blackboard
tey' = v. confide
tey' = n. cousin (parallel cousin; child of {tennuS:n} or {me':n})
tey' = n. nephew, niece (parallel nibling)
tey'be' = n. female cousin, niece (parallel)
tey'loD = n. male cousin, nephew (parallel)
tI- = v. imperative: you-them, you (plural)-them
tIch = v. insult
tIghla' = n. type of animal, t'gla
tIH = n. ray, beam
tIH = n. shaft (of spear)
tIH javmaH = n. X-ray
tIH wej = n. gamma ray
tIHmey = n. railroad tracks
tIj = v. board, go aboard
tIjwI'ghom = n. boarding party
tIl = v. salivate
tIn = v. be big
tIngvo' 'evDaq chanDaq = all around, all over the place
tIng 'ev = n. area westward, area towards the west
tIpqan = n. ash, ashes
tIq = v. be long, be lengthy (of an object)
tIq = n. heart (also used symbolically)
tIqDaq HoSna' tu'lu'. = Real power is in the heart.
tIq Hom = n. dim sum
tIqIpqu' 'ej nom tIqIp. = Hit them hard and hit them fast.
tIqleH = n. tik'leth
tIqlIj Da'angnIS. = You must show your heart.
tIqnagh = n. type of animal, tknag
tIqnagh lemDu' = n. tknag hooves (a food item)
tIquvma = n. T'Kuvma
tIqwIj Sa'angnIS. = I must show you my heart.
tIQ = v. be ancient
tIr ngat = n. bread crumbs
tIr ngogh = n. bread
tIr ngogh QaD = n. toast (dried bread)
tIr = v. be arranged in a stack, be superimposed
tIS = v. be light (weight)
tIv = v. enjoy
tIw = v. react emotionally, behave emotionally
tIy = v. be curly
tI' = v. fix, repair
tI'wI' = n. repairman, repairwoman
tI'ang = n. T'Ong
tI'qa' vIghro' = n. type of animal, tika cat
tI'rIl = n. Trill (planet)
tI'rIlngan = n. Trill (person)
tI'vIS = n. T'vis
tob = v. test conclusively, prove
toch = n. palm (of hand)
toch = v. be actual, be concrete, be practical, be pragmatic, be applied (linguistic notion)
toD = v. save, rescue
toDDuj = n. rescue ship
toDuj 'oS rol. = A beard is a symbol of courage.
togh = v. count
toj = v. deceive, trick, bluff
tojbogh pa' = n. holodeck
tojbogh pa' tuHmey = n. holodeck adventures
tol = v. go through, pass through, pass among
tom = v. tilt, be tilted
toppa' = n. type of animal, topah
toq = v. be inhabited
toqvIr lung = n. type of animal, Tokvirian skink
toQ = n. kind of bird similar to Terran bird of prey
toQDuj = n. Bird of Prey (vessel)
tor = v. kneel
tor = v. pitch (aircraft tilts nose up or down)
torgh = n. Torg
torghen = n. Torghn
toS = v. climb
toSwI' qal'aq = n. climbing apparatus, jungle gym
totlh = n. commodore
toyDal = n. tactic
toy' = v. serve (a master)
toy'wI' = n. servant
toy'wI''a' = n. slave
to' = n. tactics
to'baj = n. type of animal, tobbaj
to'baj 'uS lughoDlu'bogh tIlaj. = Accept these stuffed tobbaj legs.
to'ratlh = n. Torath
to'waQ = n. ligament, tendon
to'waQ yIv = to take some time to consider a matter
tu- = v. you (plural)-me
tu = v. blink
tuch = v. forbid
tuch rIt = to prophesize, see the future, know the future
tuch rItwI' = n. prophet, future-seer
tuD = v. thunder
tuH = v. be ashamed
tuHmoH = v. shame
tuj = v. be hot
tuj ghImwI' = n. heat exhaust
tuj muvwI' = n. thermo-suture
tuj 'otlh = n. infrared, infrared radiation
tujpa' qul pub SuvwI' 'Iw. = A warrior's blood boils before the fire is hot.
tujqu'choH QuQ. = The engine is overheating.
tul = v. hope
tun = v. be soft
tung = v. discourage
tungHa' = v. encourage
tungyen Say'qIS = n. cement (material for construction)
tup = n. minute (of time)
tup = v. be conceptual, be abstract, be pure (linguistic notion)
tuq Degh = n. family crest
tuqjIjQa' = n. United Kingdom
tuqnIgh = n. member of a house
tuqvol = n. forehead
tuQ = v. wear (clothes)
tuQHa'moH = v. undress
tuQmoH = v. put on (clothes)
tur = v. carry out, conduct (a mission), perform (duties)
turwI' = n. server (computer)
turmIq 'enDeq = n. urinary bladder
tuS = v. cough
tut = n. column
tut = n. prism (geometry)
tut Duj = n. elevator
tutren = n. knee pit, elbow pit
tutlh = v. have a tattoo, be tattooed
tutlhmoH = v. tattoo
tutlh = v. be official
tuv = v. be patient
tuy' = v. spit
tu' = v. discover, find, observe, notice
tu'lu' = v. there is, there are
tu'mI' = n. sock
tlhay = n. the consonant {tlh:sen:nolink}
tlhab = v. be free, be independent
tlhach mu'mey = n. jargon, argot
tlhaj = v. process, parade, march
tlham = n. gravity
tlham rI'gheS = n. gravity deflector, parachute
tlham = n. order, structure (societal)
tlham = v. slide
tlhan = v. dig
tlhap = v. take
tlhapragh = n. monster
tlhaq = n. chronometer
tlhaqwIj chu'Ha'lu'pu'. = My chronometer has stopped.
tlhaQ = v. be funny
tlhar = v. be allergic, be allergic to
tlhargh = v. explore
tlharwIl Duj = n. railroad car
tlhaS = v. fight, battle (relatively minor fight)
tlhatlh = n. type of food, gladst
tlhatlh vIychorgh = n. sauce for gladst
tlhavqop = n. punctuation
tlhaw = v. be inflamed
tlhaw' = v. hit (percussion instrument) with fist
tlhay = n. sleeve
tlhay = v. embalm
tlhay' = v. be tame, be domesticated
tlha' = v. chase, follow
tlha'a = n. Klaa
tlha'veq = n. Klavek
tlheb = v. urge, advocate, endorse, should, ought
tlheD = v. depart
tlhegh = n. line, rope
tlhegh jIrmoHwI' = n. windlass
tlhej = v. accompany
tlhemqaDID = n. bumpkin, yokel
tlhen = v. sound as, produce the sound of
tlheng'IQ = n. thranx
tlhep = v. be suspended, be dangling
tlhepwI' = n. {roDSon:n}
tlher = v. be lumpy
tlhetlh = v. progress
tlhey'at qIr'a' = n. spacetime continuum
tlhe' = v. turn
tlhIb = v. be incompetent
tlhIghaq = n. type of animal, trigak
tlhIH = n. you (plural)
tlhIj = v. apologize
tlhIl = v. mine
tlhIlHal = n. mine
tlhIlwI' = n. miner
tlhImqaH = n. type of food, zilm'kach
tlhIn = v. be particular, be individual, be one's own
tlhIng yoS = n. Kling district
tlhIngan = n. Klingon (person)
tlhIngan Hol = n. Klingon (language)
tlhIngan Hol Dajatlh'a'? = Do you speak Klingon?
tlhIngan Hol vIjatlhbe'. = I don't speak Klingon.
tlhIngan Hol vIjatlhlaHbe'. = I cannot speak Klingon.
tlhIngan Hol yejHaD = n. Klingon Language Institute
tlhIngan Hubbeq = n. Klingon Defense Force
tlhIngan jIH. = I am a Klingon.
tlhIngan jIHbe'. = I am not a Klingon.
tlhIngan maH! = We are Klingons!
tlhIngan ngoQmey chavmeH HoH tlhInganpu'. = Klingons kill for their own purposes.
tlhIngan SoH'a'? = Are you a Klingon?
tlhIngan quv DatIchDI' Seng yIghuH. = When you insult a Klingon's honor, prepare for trouble.
tlhIngan wo' = n. Klingon Empire
tlhIS = v. spit out
tlhIv = v. be insubordinate
tlhI'yopatra' = n. Cleopatra
tlhob = v. request, ask, plead
tlhoch = v. contradict
tlhoD = v. be somewhat obscured, be filtered, be smudged, be fuzzy
tlhogh = v. get married to, marry
tlhoghmoH = v. marry, conduct a marriage ceremony
tlhoj = v. realize
tlhol = v. be raw, be unprocessed
tlhom chum = n. sunset
tlhombuS = n. type of food
tlhon = n. nostril
tlhonghaD = n. type of animal, klongat
tlhong = v. barter, bargain
tlhop = n. front, area in front of
tlhop = n. public area
tlhorgh = v. be pungent (referring to food)
tlhorghHa' = v. be bland (referring to food)
tlhot = v. land on water (like a bird)
tlhov = v. wheeze
tlhoy' SaS = n. ceiling/floor between stories
tlho' Huch = n. tip (money)
tlho' = v. thank
tlhuch = v. exhaust
tlhuD = v. emit (energy, radiation, etc.)
tlhuDwI' yu'egh HISmoHwI' = n. emitter waveform compressor
tlhuH = v. breathe
tlhuH = v. be exhilarated, be stimulated, be invigorated
tlhuHtuch = n. armadillo-like Klingon creature
tlhum = v. be constrained, bound
tlhup = v. whisper
tlhuQ = n. tail
tlhur = v. catch (grab in midair)
tlhut = v. be stuffed
tlhutlh = v. drink
tlhutlhmeH HIq ngeb qaq law' bIQ qaq puS. = Drinking fake ale is better than drinking water.
tlhu' = v. be tempted
tlhu'moH = v. tempt
vabDot Sovbe' targhwIj. = Even my targ won't know.
vaD = v. be flexible
vagh = n. five
vaghDIch = n. fifth
vaghmaH = n. fifty
vagh = n. fifth tone of nonatonic musical scale
vagh reD mey' = n. pentagon
vaj Duj = n. strength of character
vaj Duj chIj = to have strength of character
val = v. be clever, be smart, be intelligent
valQav = n. iris (of the eye)
valQIS = n. Valkris
valqe' = n. bat-like Klingon creature, type of animal
van = v. salute
van = v. end (an event, voyage, battle, play, opera, story, song, etc.)
vanDIroS = n. Vandros IV
van'a' = n. award
van bom = n. anthem, hymn
van Hew = n. monument, memorial (sculpture)
van qach = n. monument, memorial (building)
vang = v. act, take action
vangDI' tlhIngan SuvwI' ngoy' qorDu'Daj; vangDI' qorDu'Daj ngoy' tlhIngan SuvwI'. = The family of a Klingon warrior is responsible for his actions, and he is responsible for theirs.
vaq = v. mock
vaq'aj cha' = n. Vaq'aj II
vaQ = v. be aggressive, be effective, be vigorous
var = v. be stingy, be miserly
varHa' = v. be generous
varghwI' = n. Changeling, Founder
vaS'a' = n. Great Hall
vaS = v. be wide, broad
vatlh = n. hundred (number-forming element)
vatlhbIp = n. ten million (number-forming element)
vatlhSaghan = n. hundred billion (number-forming element)
vatlh'uy' = n. hundred million (number-forming element)
vatlh DIS poH = n. century
vatlh = v. coil
vatlhmoH = v. roll up (a scroll)
vav = n. father
vavoy = n. daddy
vavnI' = n. grandfather
vaw = v. be ambitious, be determined, be motivated
vay = v. fight, battle (midlevel ferocity)
vay' = n. somebody, something, anybody, anything
vay' DaneHbogh yIchargh. = Conquer what you desire.
vay' DaghIjlaHchugh bIHoSghaj. = Fear is power.
vay' DalarghDI' yIqaw. = Remember the scent.
va'nuch = n. heel (of foot)
veb = v. be next (in a series, sequence)
vech = v. cross, span
veD = n. fur
veDDIr = n. pelt (skin with fur still attached)
vegh = v. go through an existing opening (an open door, a tunnel, etc.)
veH tIn = n. Great Barrier
veH Qav 'oH logh'e' = "Space: the final frontier"
vel = v. cover, coat, mask
velwI' = n. carpet layer (person)
velSo' 'uSqan = n. stainless steel
vem = v. wake up, cease sleeping
vemmoH = v. wake (someone) up
vemmoH = v. ignite (a fire)
vem'eq = n. a kind of bird
ven = v. be nerdy
venwI' = n. nerd
veng = n. city
vengHom = n. village
veng wa'DIch = n. First City, capital of {Qo'noS:n}
veng wa'DIch Sep = n. First City region
veqlargh = n. "devil", demon, Fek'lhr (guardian of Gre'thor)
veqlarghlI' yIbuS 'ej veqlarghwI' vIbuS. = You pay attention to your Fek'lhr and I will pay attention to mine.
veQ = n. garbage
veQDuj = n. garbage scow
veQDuj 'oH DujlIj'e'. = Your ship is a garbage scow.
ver = v. be spiral
ver = v. be dizzy
verengan = n. Ferengi
verenganar = n. Ferenginar
verengan Ha'DIbaH = n. Ferengi dog, an insult
vergh = v. dock
veSDuj = n. warship
veStay = n. vestai (rank)
vetlh = n. cockroach
vev = v. insert, put in, pin (attach or fasten with a pin)
vey' = v. be comfortable, be plentiful
vey'Ha' = v. be uncomfortable, be meager
ve' = v. travel with a purpose, for a specific reason; travel on a mission
ve'Ha' = v. be wavy (hair)
vI- = v. I-him/her/it/them
vIb = v. move through time toward the future
vIb = v. propagate (not in reference to plants)
vIbHa' = v. move through time toward the past
vID = v. be belligerent
vIghro' = n. type of animal, v'gro (like a cat)
vIH = v. move, be in motion
vIHtaH gho = the hoop is moving
vIj = n. thruster
vIl = v. be ridgy (of the forehead)
vIl = v. be cool (as in chic)
vIlle' = n. follower, disciple, fan, admirer, minion
vIlHom = n. forehead ridge
vIlInHoD = n. a kind of bird, parrot
vIn = n. cousin, nephew, niece ({lor:n:0} or {tey':n:0})
vInDa' = n. compatriot, community member, cohort, fellow citizen
vIno'va' qurgh = n. finova bean(s)
vIng = v. whine
vIqSIS = n. Vixis
vIQ = v. suffocate
vIQmoH = v. smother
vIrgh = v. rip (up), slash, tear (up), gash
vISeHmeH Hoch nuHmey Qay! = All weapons to my control!
vIt = v. tell the truth
vIta'pu'be'. = I didn't do it.
vIttlhegh = n. proverb
vItlh = v. be high, be great (in quantity, size, intensity)
vIychorgh = n. juice, sap of a plant
vI' = v. accumulate
vI' = n. sharpshooting, marksmanship
vI' = n. decimal point
vI' = n. point (geometry)
voD = v. drill, bore
voD jan = n. {voDmeH jan:n}
voDmeH jan = n. drill (device)
voDchuch = n. spider-like creature
voDleH = n. emperor
voDleH Ha'DIbaH = n. emperor's meat
vogh = n. somewhere
voHDajbo' qav'ap = n. mortgage value
volchaH = n. shoulder
von = v. trap, entrap
vonlu' = v. fail utterly
vong = v. hypnotize
voq = v. trust, have faith in
voqHa' = v. distrust
voq = n. Voq
voQ = v. choke
vor = v. cure
vorcha' = n. Vor'cha (vessel)
vorgh = v. be previous
voSpegh Sep = n. Vospeg region
votlh = v. be narcissistic
vov = v. grapple, wrestle, tussle
voveng = n. gland
voy = v. clone (something)
vo' = v. propel
vo'yajer = n. Voyager
vub = n. hostage
vubpu' jon nuchpu'. jonbe' tlhInganpu'. = Cowards take hostages. Klingons do not.
vuD = n. opinion
vuj = v. expel, eject
vul = v. be unconscious
vulchoHbe' tlhInganpu'. = Klingons do not faint.
vulqan = n. Vulcan (planet)
vulqangan = n. Vulcan (person)
vulqan Hol = n. Vulcan (language)
vum = v. work, toil
vum = n. contemptible or despicable person, scumbag, bastard
vun = v. order (in a restaurant, from a catalog, etc.)
vung = v. cyclone, hurricane
vup = v. pity
vuQ = v. fascinate
vur = v. be modern, be up-to-date, be state-of-the-art
vuS = v. limit
vut = v. cook, prepare food, make a beverage
vutmeH 'un = n. flat-bottomed pot for food preparation
vutwI' = n. cook, chef
vutwI' quv = n. head chef
vut'un = n. flat-bottomed pot for food preparation
vuv = v. respect
vuy = v. be helpful, be supportive
vu' = v. manage
vu'wI' = n. manager
wab choHwI' = n. synthesizer (musical instrument)
wab HevwI' = n. radio
wab labwI' = n. radio transmitter
wab naQ = n. vowel
wab poD = n. consonant
wab qoSta' 'aplo' = n. cassette
wab ta = n. audio, sound record
wabDo = n. Mach number
wagh = v. be expensive
waH = v. try out, test, use experimentally
waH = v. taste, try out (food)
wal = v. vibrate, be in a state of vibration
wam = v. hunt
wamtaH = be libidinous
wamwI' = n. hunter
wamwI' Ha'DIbaH = n. hunter's meat
wam = n. wam, type of serpent
wan = v. be straight (not crooked)
wanHa' = v. be crooked, be bent
wanI' = n. phenomenon, event, occurrence, effect
wanI' SubmaH = n. frequency, occurrence ratio
wang = v. wink
waq = n. shoe
waqboch = n. a kind of bird
waQ = v. obstruct
warjun = n. type of knife (used for food preparation)
waS = v. be wrong, be awry, be amiss
watlh = v. be pure
wav = v. divide
way = v. be striped
way' = v. parry, deflect a lunge
wa' = n. one
wa'DIch = n. first
wa'Hu' = n. yesterday
wa'leS = n. tomorrow
wa'maH = n. ten
wa'maHDIch = n. tenth
wa' Dol nIvDaq matay'DI' maQap. = We succeed together in a greater whole.
wa' DoS neH yIbuS. = Focus on but one target.
wa' DoS wIqIp. = We agree.
wa' jaj 'etlh 'uchchoHlaH tlhIngan puqloD; jajvetlh loD nen moj. = The son of a Klingon is a man the day he can first hold a blade.
wa' Qu'vaD wa' DevwI' tu'lu'. = For one mission, there is one leader.
wa' rutlh qam Do Duj = n. unicycle
wa' SuvwI' muHlu'DI', tuHchoH Hoch SuvwI'pu'. = The execution of but one warrior brings shame to all.
wa' wa' wa'. = It's complicated.
wa'maH cha' pemmey wa'maH cha' rammey je = a long time
wa'maH wej. = It's complicated.
wa'jo''a' = n. Wa'Joh'a'
web = v. be disgraced
web = v. be chaotic, be disorganized
wech = v. serve fermented food at its peak
wegh = v. confine
weH = v. raid
wej = n. three
wejDIch = n. third
wejmaH = n. thirty
wej Heghchugh vay', SuvtaH SuvwI'. = A warrior fights to the death.
wel = v. owe
wem = v. violate
wem = n. violation
wep = n. jacket, coat
wep = n. shirt with sleeves
weq = v. hit (percussion instrument) with palm
wer = v. be creased, be wrinkled
wermoH = v. crease, wrinkle
weS = v. lose, undergo a reduction of, suffer a reduction of
weSjech ba'Suq Duj = n. hot air balloon
wev = v. sketch, doodle
wew = v. glow
wey jolpat = n. personnel transporter
wI- = v. we-him/her/it
wIb = v. be sour, be bitter, be tart
wID = v. massacre
wIgh = n. genius
wIH = v. be ruthless
wIj = v. farm
wIjwI' jan = n. plough
wIjwI' ngeb = n. scarecrow
wIj jup = "friend mine"
wIl = v. be short (in length)
wIlle' = n. joint
wItlh = v. break (something) off
wIv = v. choose, select
wIy = n. schematic, graphic representation
wIy = n. tactical display (mode)
wIy yIcha'! = Show the tactical display!
wob = v. hurl a spear by means of a {chetvI':n:2}
woch = v. be tall
woD = v. throw away
woD = v. be hollow
wogh = v. transgress, do more than is acceptable
woH = v. pick up
woj = v. sterilize
woj choHwI' = n. reactor
wol = v. be creased, be folded
wolmoH = v. crease, fold
wom = v. peck
woq = v. confirm, substantiate, corroborate
wornagh = n. warnog, Klingon ale
woS = n. chin
woSwa' = n. armadillo-like creature (rolls into ball when in danger), type of animal
woSwa' ghew = n. rolling bug
wot = n. verb
wot chuS = n. verb which does not express a state, quality, or condition; non-adjectival verb
wot tam = n. verb which expresses a state, quality, or condition; adjectival verb
wov = v. be light, bright
wovmoHbogh jan = n. light (device)
wovmoHwI' = n. light (lamp)
wovmoHwI' moQ = n. light bulb
wo' tay' = n. United Kingdom
wo' toy'taHvIS Hegh 'e' tul Hoch tlhIngan. = To die while serving the Empire is the hope of every Klingon.
wo'rIv = n. Worf
wuD = v. snore
wuH = v. skim, glide, skate, skid
wun = v. be unprotected, be vulnerable
wup = v. burst into song
wuq = v. decide, decide upon
wuqHa' = v. commute (a judicial sentence)
wuqwI' = n. juror (not Klingon concept)
wuqwI' ghom = n. jury (not Klingon concept)
wuQ = v. have a headache
wuS = n. lip
wuS rItlh naQ = n. lipstick
wutlh pa' = n. dungeon
wuv = v. depend on, rely on
wuvchuq = v. be entangled (quantum physics)
wu' = v. be mystical, be esoteric, be occult
wu'DIy = n. beaver, Klingon beaver-like animal
yay = n. the consonant {y:sen:nolink}
ya = n. tactical officer
ya De'wI' = n. tactical computer
ya pat = n. tactical system
yab = n. mind, brain, intellect
yab qoD = n. subconscious mind
yach = v. pet, stroke
yach = v. strum (a stringed instrument)
yaD = n. toe
yaD = n. sword
yaD = n. teen, teenager, adolescent, youth, young adult
yaDe'ra' wa' = n. Yadera Prime
yaH = n. duty station, station
yaH = v. be taken away
yaj = v. understand
yajHa' = v. misinterpret
yaj'a'? = Understood? Do you understand?
yajchu'. = Understood clearly.
yam = v. be assimilated, be incorporated, be subsumed
yamtaw job = n. jagged line, zigzagging line
yan = n. sword
yan 'ISletlh = n. Brotherhood of the Sword, Yan-Isleth
yan = v. use or manipulate a sword
yanwI' = n. swordfighter
yap = v. be enough, be sufficient
yaS = n. officer
yaS cha'DIch = n. Second Officer
yaS pa'mey = n. officers' quarters
yaS wa'DIch = n. First Officer
yaS = n. professional
yatqap = n. a kind of bird
yatlh = v. be pregnant
yay = n. victory, triumph
yay chavlu' 'e' bajnISlu'. = Victory must be earned.
yay mIr = n. winning streak
yay SubmaH = n. victory ratio, frequency of victories
yay = n. scribbles, doodle
yay' = v. be shocked, be dumbfounded
yeb = n. wrist
yeb = n. slang term of deprecation
yegh = v. be spotted
yejquv = n. High Council
yejquv DevwI' = n. Leader of the High Council
yem = v. sin
yep = v. be careful
yepHa' = v. be careless
yeq = v. cooperate
yer chaw' = n. {yer ghajwI' chaw':n}
yer ghajwI' chaw' = n. title deed
yergho = n. wall of a city
yev = v. pause
yI- = v. imperative: you-none, you-him/her/it, you (plural)-him/her/it
yIH = n. tribble
yIHotlh! = Put him on screen.
yIHotlh! = Scan it!
yIHu'! = Get up!
yIja'Qo'! = Don't tell him/her!
yIje'! = Feed him!
yIjonHa'! = Release him!
yIjuntaH! = Take evasive action!
yIlop! wa'leS chaq maHegh! = Celebrate! Tomorrow we may die!
yIqIm! = Pay attention!
yIn = n. life
yIn = v. live
yIn DayajmeH 'oy' yISIQ. = To understand life, endure pain.
yIn nI' yISIQ 'ej yIchep! = Live long and prosper!
yInbogh lom = n. zombie
yInlu'taH 'e' bajnISlu'. = Survival must be earned.
yInroH = n. life signs
yInSIp = n. oxygen
yIntagh = n. life-support system
yIntaHbogh qagh jablu'DI' reH nIvqu' qagh. = Gagh is always best when served live.
yIn 'eSqa' = n. environmental suit
yIpIv! = Be healthy! Get well!
yIQ = v. be wet
yIQeqQo' neH. DoS yIqIp! = Don't just aim; hit the target!
yIr = v. gather
yIratlh! = Stay!
yIrIDngan = n. Yridian (person)
yIr'ach = n. close friend
yISo'rup. = Prepare to cloak.
yISo'Ha'rup, yIghuS. = Stand by to de-cloak for firing.
yIt = v. walk
yItlh = v. be strict, be severe, be firm, be stern, be authoritarian
yItlhHa' = v. be lenient, be indulgent
yIv = v. chew
yIv = v. annoy, bother, irk, irritate
yIvbeH = n. tunic
yIvbeH = n. sleeveless shirt
yIvbeH naQHa' = n. vest, waistcoat
yIvoq 'ach lojmItmey yISam. = Trust, but locate the doors.
yIvoq 'ach yI'ol. = Trust, but verify.
yI' = v. speak in an honorable or respectful fashion
yI'De' = n. cervid-like animal, type of animal
yo = v. slap, hit with palm
yob = v. harvest
yobta' yupma' = n. harvest festival
yoD = n. shield (plate of material, not force field)
yoD = v. shield
yoH = v. be brave
yoHwI' = n. brave one
yon = v. be satisfied
yonmoH = v. satisfy
yong = v. get in
yopwaH bID = n. shorts
yoq = n. humanoid
yoq yIn yuQ = n. class-M planet
yor = v. sulk, mope, pout
yorqej = n. nomad
yot = v. invade
yotwI' = n. intruder
yov = v. charge (military term)
yoy = v. be upside down
yoymoH = v. turn upside down, flip, invert
yo' qIj = n. Black Fleet
yuch = n. chocolate
yuD = v. be dishonest
yuDHa' = v. be honest
yugh = v. include, consist of, be composed of
X neH yughmoH = filter for X only, include X only
yul = v. be itchy
yup = v. pump
yuq = v. outwit, outsmart
yuQ = n. planet
yuQHom = n. planetoid
yuQjIjDIvI' = n. United Federation of Planets
yuQjIjQa' = n. United Federation of Planets
yuQQeD = n. geography
yuQtej = n. geographer
yut = v. distract, create a diversion
yutlhegh = n. spectrum, musical scale, range
yur = n. cousin, nephew, niece (distant)
yuv = v. push
yu' = v. question, interrogate
yu'egh chungwI' = n. waveform accelerator
yu'egh meqHoD 'och = n. waveform bypass conduit
'ab = v. have a length/height of
'ab = v. be at a latitude
'achler = n. nape, scruff, back of neck
'aD = n. vein, artery, blood vessel
'aDHom = n. capillary
'aD = v. have a length of, measure
'agh = v. show, demonstrate, display
'aj = n. admiral
'al = v. float (in/on air)
'al = v. be random (number)
'alghuQ = n. bastard, illegitimate child
'alnum = n. freckle
'alngegh = n. ax with spike at end
'alwI' = n. parachute
'an = v. be a waste
'anmoH = v. sacrifice, waste
'an = v. be petrified
'anDor = n. Andoria
'anDorya' = n. {'anDor:n}
'anDorngan = n. {'anDorya'ngan:n}
'anDorya'ngan = n. Andorian
'antonI' = n. Antony
'anyan 'oQqar = n. onion
'an'orQeD = n. paleontology
'an'ortej = n. paleontologist
'ang = v. show, reveal
'ang'eghQo' quv Hutlhbogh jagh neH ghobtaHvIS ghaH. = Only an enemy without honor refuses to show himself in battle.
'angwIl = n. an individual member of the Kos'Karii
'ap = v. be dented
'apmoH = v. dent
'aplom chuch = n. {chuch 'aplom:n}
'apuStoQ = n. a hawk-like bird
'aq = v. predict, prognosticate
'aqleH = n. type of weapon (half ax, half bat'leth)
'aqroS = n. bottom surface of a table, ceiling
'aqroS = n. maximum
'aqtu' = n. Aktuh
'aQlo' = n. forehead
'argh = v. worsen
'arlogh Qoylu'pu'? = What time is it?
'at = v. inherit
'atrom = n. A'trom
'atlhqam tun = n. type of mold
'av = v. guard
'avwI' = n. guard
'avwI' nejDI' narghta'bogh qama' reH 'avwI' Sambej. = When an escaped prisoner looks for a guard, he always finds one.
'aw = v. go through, pass through (matter)
'awje' = n. type of beverage (root beer)
'awtIr ngutlh = n. musical note (written notation for specific sound)
'aw' = v. sting
'ay = v. float (in/on liquid)
'a'ghen = n. master teacher, professor
'a'Setbur = n. Azetbur
'et = n. the vowel {e:sen:nolink}
'eb = n. opportunity, chance, opening
'eb Qav = n. last call
'ebmey jonHa' = kill time
'ebHIv pa' = n. distillery (room)
'ebHIv qach = n. distillery (building)
'ech = n. brigadier
'echlet Hab = n. touchpad
'echletHom = n. card
'echletHom vey = n. deck of cards
'eD = v. crawl
'eDSeHcha = n. take-off/landing thrusters
'ejyaH = n. infinity
'ejyo' ra'ghomquv = n. Starfleet Command
'ejyo'waw' = n. starbase
'el = v. enter, go in
'elHa' = v. exit
'elaS = n. Elas
'elmeH chaw' = n. ticket, entry pass
'em = v. vomit
'emrIgh = n. ancestor (from which one is descended by bloodline)
'emvI' ngaQ = n. safety pin
'en = v. be not something, non-
'enDeq = n. bladder
'entepray' = n. Enterprise
'eng = n. cloud
'ep = v. consume soup
'ep = v. human-style kiss
'eQway = n. belly button
'eQway' 'echlet = n. mousepad
'eq = v. be early
'er = n. type of animal
'ergh = v. hallucinate
'eS = v. be low (in height)
'et = v. bounce, rebound, ricochet
'et = n. fore
'etlh QorghHa'lu'chugh ragh 'etlh nIvqu' 'ej jejHa'choH. = Even the best blade will rust and grow dull unless it is cared for.
'ev tIng = n. {tIng 'ev:n}
'ev = v. applaud
'evnagh Se' HablI' = n. subspace radio
'evta' = n. newt, salamander, type of animal (Klingon salamander-like creature)
'ey = v. be good, be delicious, be tasty, be harmonious
'eyHa' = v. be undelicious
'e' = n. that (previous topic)
'e' qa' = instead of
'e'mam = n. aunt (father's sister)
'e'mamnal = n. aunt (father's brother's wife)
'e'nal = n. someone who married into the family
'Ich = v. be slippery
'IDnar lIl = perform magic
'IDnar lIlwI' = n. magician
'IDnar pIn'a' = n. wizard, sorcerer
'Igh = v. be cursed, be jinxed
'IghvaH = n. type of animal, igvah
'IghvaH chej chatlh = n. igvah liver soup
'IH = v. be beautiful, be handsome
'Ij = v. listen
'Il = v. be sincere
'IlHa' = v. be insincere
'Im = v. render, boil (fat)
'ImtIy = n. cameloid animal without hump, type of animal
'InSep = n. penis
'Ing = v. move clockwise
'Ip = n. oath, promise
'Ip = v. vow, swear
'Ipnal = n. spouse (gender-neutral term)
'Iptay = n. epetai (rank)
'Iq = v. be too much, be too many
'IqnaH QaD = n. dry mucus, booger
'IQ = v. be sad
'Ir = v. guess, suppose, imagine
'Ir = v. be creamy, be pasty
'Irgh = v. bully, intimidate, pick on, harass
'IrneH = n. uncle (mother's brother)
'IrneHnal = n. uncle (mother's sister's husband)
'ISjaH = n. calendar
'It = v. be depressed
'Itlh = v. be advanced, be highly developed
'Iv = n. altitude
'IvtIH = n. hip
'Iw = n. blood
'Iw bIQtIqDaq jIjaH. = I travel the river of blood.
'Iw bIQtIqDaq bIlengjaj. = May you travel the river of blood.
'Iw Doy' = n. {lotregh:n}
'Iw HIq = n. blood wine
'Iw HIq yap tu'lu'be'. = Sufficient blood wine does not exist.
'Iw puj = n. diluted blood
'Iw remwI' = n. vampire
'Iw 'Ip ghomey = n. Blood Oath Circles (famous statue)
'Iwghargh = n. bloodworm
'IwlIj ghogh yIQoy. = Listen to the voice of your blood.
'IwlIj jachjaj! = May your blood scream!
'IwwIj jeD law' 'IwlIj jeD puS. = My blood is thicker than yours.
'I' = n. armpit
'I' ghew = n. a bug that sort of resembles a beetle
'o 'oghlu'meH qul = O for a Muse of fire
'ob = v. be curved, be arced
'obmaQ = n. ax
'obray'wal = n. scorpion-like creature
'och mutlhwI' = n. plumber, pipe layer
'oD = v. arbitrate, mediate
'oDwI' = n. arbitrator
'ogh = v. invent, devise
'oH = n. it
'oj = v. be thirsty
'ol = v. verify, check if (something) is true, make sure that (something) is true
'om = v. resist, fend off
'ong = v. be cunning, be sly
'opDIch = n. nth
'opleS = n. one day, some day
'op ret = n. at some point in the past
'oq = v. sink
'oqmoH = v. submerge
'oQqar = n. root, tuber
'oQqar qIj = n. black root
'or = v. pilot, operate (an aircraft)
'oray = n. Orion (planet)
'orayya' = n. {'oray:n}
'orayngan = n. Orion (person)
'orayya'ngan = n. {'orayngan:n}
'orgh = v. skitter
'orghen = n. Organia
'orghenya' = n. {'orghen:n}
'orghen rojmab = n. Organian Peace Treaty
'orghenya' rojmab = n. {'orghen rojmab:n}
'orghengan = n. Organian
'orghenya'ngan = n. {'orghengan:n}
'orwI' = n. pilot, one who operates (an aircraft)
'or'eq = n. Or'Eq
'oS = v. represent
'oSwI' = n. emissary
'oSHeQ = n. spleen
'ot = v. withhold (information)
'otHa' = v. disclose, divulge
'otlh peng = n. photon torpedo
'otlh peng baHjan = n. photon torpedo launcher
'otlh poH = n. Planck time
'otlhQeD = n. quantum theory, quantum mechanics, quantum physics
'otlhtej = n. quantum physicist
'otlh tlhuDmeH Qorwagh = n. photon spill window
'ov = v. compete
'ovwI' = n. competitor, player
'ovjeq'IS = n. professional
'oynot = n. unspecified flesh (of an animal)
'oy' = v. ache, hurt, be sore
'oy'be'lu'chugh Qapbe'lu'. = No pain, no gain.
'oy'naQ = n. painstik
'oy'naQ Dalo'be'chugh not nenghep lop puq. = If you don't use the painstik, the child will never celebrate his Age of Ascension.
'oy'qu' Qay'wI'wIj. = I'm extremely angry.
'oy''a'? = Will it hurt?
'oy' DaSIQjaj! = May you endure the pain!
'o' chuyDaH = n. aft thrusters
'o'lav'a' = n. bass drum
'o'mat ghIrI', tI'Im, pIvyoch = n. O'mat Gri T'M pffiots
'o'mat ghIrI' = n. O'mat Gri
'ub = v. be lonely
'uch = v. hold, grasp
'uch = v. lock on (a target)
'uch = v. include, consist of, be composed of
'uch = v. absorb (of music)
'uchHa' = v. let go of
'uD Haqtaj = n. laser scalpel
'ugh = v. be heavy
'ughDuq ghargh = n. caterpillar
'uH = v. have a hangover, be hung over
'uj'a' = n. unit of length (313.47 cm)
'uj'IllI' = n. Ujilli
'ul gho = n. circuit
'ul ghom'oH = n. electrical outlet
'ul pat mutlhwI' = n. electrician
'ul rarwI' = n. electrical plug
'ul Sech = n. flashlight
'ul 'aplo' = n. battery, electrochemical cell
'um = v. be qualified
'umHa' = v. be unqualified
'un = n. pot (for food preparation) (general term)
'un naQ = n. stirring stick, mixing stick
'un quD = n. artificially produced {quD:n:nolink}
'ung = v. squat (down)
'up = v. be unsavory, be disgusting, be repugnant, be loathsome, be icky
'uq = v. whistle
'uQ = n. dinner
'uQ'a' = n. banquet, feast
'uQ pa' = n. dinner room, dining room
'ur = v. treason, commit treason
'urwI' = n. traitor
'urgh = v. jab, poke
'urgh neH = tinker
'urghwI' = n. Poker (card game)
'uS = n. leg
'uS cha'neH = n. crus (lower part of leg)
'uS nev'ob = n. thigh
'uS reStav = n. shin
'uS tutren = n. knee pit
'uSgheb = n. a kind of bird, rooster (makes ruckus at dawn)
'uSu' = n. sauce for gladst
'ut = v. be essential, be necessary
'utbe' = v. be nonessential, be unnecessary
'utbe' bel. = Pleasure is nonessential.
'utlh = n. officer, officer emeritus
'uy = v. press down
'uy' = n. million (number-forming element)
'u' Dop = n. mirror universe
'u' quq = n. parallel universe
0 = v. he/she/it-none, he/she/it-him/her/it, he/she/it-them, they-none, they-them
-'a' = n. augmentative (noun type 1)
-Hom = n. diminutive (noun type 1)
-oy = n. endearment (noun type 1)
-pu' = n. plural (beings capable of using language) (noun type 2)
-Du' = n. plural (body part) (noun type 2)
-mey = n. plural (general) (noun type 2)
-qoq = n. so-called (noun type 3)
-Hey = n. apparent (noun type 3)
-na' = n. definite (noun type 3)
-wIj = n. my (noun type 4)
-wI' = n. my (noun capable of using language) (noun type 4)
-maj = n. our (noun type 4)
-ma' = n. our (noun capable of using language) (noun type 4)
-lIj = n. your (noun type 4)
-lI' = n. your (noun capable of using language) (noun type 4)
-raj = n. your (plural) (noun type 4)
-ra' = n. your (plural) (noun capable of using language) (noun type 4)
-Daj = n. his, her, its (noun type 4)
-chaj = n. their (noun type 4)
-vam = n. this (noun type 4)
-vetlh = n. that (noun type 4)
-Daq = n. locative (noun type 5)
-vo' = n. from (noun type 5)
-mo' = n. because, due to (noun type 5)
-vaD = n. for (noun type 5)
-'e' = n. topic (noun type 5)
-'egh = v. oneself (verb type 1)
-chuq = v. one another, each other (verb type 1)
-nIS = v. need (verb type 2)
-qang = v. willing (verb type 2)
-rup = v. ready, prepared (referring to beings) (verb type 2)
-beH = v. ready, set up (referring to devices) (verb type 2)
-vIp = v. afraid (verb type 2)
-choH = v. change in state, change in direction (verb type 3)
-qa' = v. resume, do again (verb type 3)
-moH = v. cause (verb type 4)
-lu' = v. indefinite subject (verb type 5)
-laH = v. can, able (verb type 5)
-luH = v. one can (verb type 5 - ungrammatical)
-la' = v. one can (verb type 5 - ungrammatical)
-chu' = v. clearly, perfectly (verb type 6)
-bej = v. certainly, undoubtedly (verb type 6)
-ba' = v. obviously (verb type 6)
-law' = v. seemingly, apparently (verb type 6)
-pu' = v. perfective (verb type 7)
-ta' = v. accomplished, done (verb type 7)
-taH = v. continuous (verb type 7)
-lI' = v. progress (verb type 7)
-neS = v. honorific (verb type 8)
-DI' = v. when, as soon as (verb type 9)
-chugh = v. if (verb type 9)
-pa' = v. before (verb type 9)
-vIS = v. while (verb type 9)
-mo' = v. due to, because of (verb type 9)
-bogh = v. which (verb type 9)
-meH = v. for, for the purpose of, in order to (verb type 9)
-'a' = v. interrogative (verb type 9)
-jaj = v. may, let (verb type 9)
-wI' = v. one who does/is, thing which does/is (verb type 9)
-ghach = v. nominalizer (verb type 9)
-be' = v. not (verb type R)
-Qo' = v. don't!, won't! (verb type R)
-Ha' = v. undo, do wrongly (verb type R)
-qu' = v. emphatic (verb type R)
Doq'a' SuvwI'pu'? = Are warriors red?
ghorgh pa'wIjDaq jIchegh? = When can I return to my room?
Ha'DIbaHmey meQ Sop 'e' tIv tera'nganpu'. = Terrans enjoy eating burnt animals.
naDev vay' DaSov'a'? = Do you know anyone here?
naDev vay' vISovbe'. = I don't know anyone here.
naDevvo' jIleghlaHchu'be'. = I can't see well from here.
not Soj QaQ Qaw' tlhInganpu'. = Klingons never destroy good food.
pa'vo' pagh leghlu'. = The room has no view.
qIp'egh nachDu'chaj, tlhIngan SuvwI'pu'. = Klingon warriors are butting heads.
Qo'noSDaq paw cha' DIvI' beq. = Two Federation crewmen arrive on Kronos.
yIyong 'ej pa' yIQam! = Get in and stand there!
HurDaq tu'HomI'raHvetlh yIlan! = Get that piece of junk out of here!
bach Do', qaH! = A lucky shot, sir!
baHwI', DoS yIbuS. QuQ neH. = Gunner, target engine only.
HablI', Su' labbeH. = Prepare to transmit.
He chu' ghoS, DIvI' neHmaH. = New course, Federation neutral zone.
matHa', DoS jonta' neH. = Gunner, target engine only.
naDev qaS wanI' ramqu'. = There's nothing happening here.
qama'pu' jonta' neH. = I wanted to capture prisoners.
qa'vam De' vIje' rIntaH. = I have purchased the Genesis data.
Qu'vaD lI' net tu'bej. = One certainly finds it useful for the mission.
vaj Daleghpu'. = Then you have seen it.
wa' yIHoH. jISaHbe'. = Kill one of them. I don't care which.
cha'maH vagh vatlhvI' Hong, QIt yIghoS. = Slow to one quarter impulse.
chorghSaD qelI'qam HIvchuq'e' vInoH. = Estimating attack range in 8,000 kellicams.
DIvI' Se' wI'IjtaHvIS DaH ngoqDe' wIHevta'. = We've just received an encoded message on the Federation frequency.
DoS wIpuStaH. = We have a target in sight.
DujHomDaq ghaHtaH. = He's on the shuttlecraft.
ghoSmeH yIpegh. = Stealth approach.
HeDaj yIqIm. = Track her course.
Hevetlh wIghoSchugh, veH tIn wI'el maH'e'. = That course will take us into the Barrier as well.
He pagh-pagh-pagh-DoD-cha' yInab! = Plot course zero-zero-zero, mark two.
jonlu'meH wo'maj pop tIn law' Hoch tIn puS. = Our Empire's highest bounty has been placed on his head.
mImQo'. DaH Heraj yIchoH. = Do not delay. Alter your course now.
muSuvbogh DoS vIpoQ. = I need a target that fights back.
naDev maH 'e' luSovbe'. = They don't know we're here.
nImbuS wej maghoS, He yInab. = Plot course for Nimbus III.
nImbuS wejDaq 'ejDo' 'entepray' ngeHlu'pu'. = The Starship Enterprise has been dispatched to Nimbus III.
nom yIghoSqu'! = Maximum speed!
qIbDaq SuvwI''e' SoH Dun law' Hoch Dun puS. = You would be the greatest warrior in the galaxy.
qIrq wItlha'taHqu'. = Where Kirk goes, we follow.
reH DIvI' Duj vISuv vIneH. = I've always wanted to engage a Federation ship.
vaj toDuj Daj ngeHbej DI vI'. = Shooting space garbage is no test of a warrior's mettle.
yIntaHvIS qIrq DuHbe' roj. = There will be no peace as long as Kirk lives.
yo'SeH yaHnIvvo' potlh De' wIHevtaH. = We are receiving a priority message from Operations Command.
'entepray' Hub patmey luchu'be'lu'pu'. = Enterprise defense systems are down.
'entepray' yIghoS. = Follow the Enterprise.
'entepray' 'oH DoS'e'. = Enterprise targeted.
cheng'e' DaH Sam! = Find Chang now!
DaH machegh. = We're returning now.
DIHIvbe'chugh qo'chajDaq toy'wI''a' DImoj! = Attack or be slaves in their world!
DIHIvlaHtaHvIS DaH DIHIvnIS! = Attack them now, while we still can!
ghewmey tISuqQo'. = Don't catch any bugs.
ghu'maj Dayajbe'law'. = You don't seem to understand our situation.
notlh veS, 'a tugh manotlhchoH je maH. = War is obsolete, as we are in danger of becoming.
numagh! = They have betrayed us!
nutojbej! = We've been betrayed!
Qang yIQan! = Protect the Chancellor!
tlham chach chu'qa'. = Restoring auxiliary gravity.
tlham chu'Ha'lu'! = We've lost gravity!
jIvuylaH. jIve'. = I am here to help you.
ghach jIvvo' naH. DaH pIghvamDaq So''eghtaH. = There is a criminal hiding in these ruins.
Qob lIb bam SoH chuDlI' je. = You and your people are in danger.
Qugh la'vaD QIn pav. = Urgent message for Commander Kruge.
qa'vam jan SeH DIvI'. = The Federation controls the Genesis Device.
qa'vam yuQ Quv DaghojmeH Duyma'vaD yIjatlh. = To learn the Genesis Planet's coordinates, speak to our agent.
qa'vam jan yISuq. = Acquire the Genesis Device!
potlhbe' to'. = Tactics aren't important.
tlhIngan chang'engvetlh = That Klingon Couple
toH, SomrawDu' Dunqu'! = Oh, what wonderful muscles!
'archer HoD = n. Captain Archer
quv lughaj 'archer HoD beqDaj je. = Captain Archer and his crew are honorable people.
lengtaH 'e' yIchaw'. = Let them continue on their way.
SoHvaD pagh vIjatlh, Human. = I have nothing to say to you, human.
loHwI' vISuch 'e' vIpoQ! = I demand to see the magistrate!
vImuHlu' net wuqHa'! = My death sentence was commuted!
qatlh tuneH? = What do you want with me?
yIngaQmoH! = Secure him!
'ay'vamDaq nuHmey tIQeq. = Target weapons on this location.
jol Quv yIchegh. = Return to the transport site.
ghetwI' luwIvlu'ta'. = The actors have been chosen.
qul yIchu'. = Light the Fire.
ghIq chalDaq HovDaq SIq qeylIS 'ej jatlh pa' DaqHomvetlh wovDaq HInej. = Then Kahless pointed to a star in the sky and said, "Look for me there, on that point of light."
ghoSlI' chaH. = They are coming.
tlhIngan maH! taHjaj! = Remain Klingon!
'Iv wInej? = Whom do we seek?
ghu' Dachupbogh vIlaj. = I accept your proposal.
molor 'etlh bID wItlh qeylIS. = Kahless broke Molor's sword in half.
paq'jachchu = n. Book of the Perfect Scream
paq'yav = n. Ground Book
paq'raD = n. Force Book
paq'QIH = n. Impact Book
pewuv'egh! = You need no one but yourselves!
QIch'lut = n. Qich'lut, narrator style (type of literary style)
'aqaD = n. Akkad
'aqaDyan Hol = n. Akkadian language
baDjer Hajvav = n. badger (Terran animal)
bagh'et = n. baguette (Terran bread)
bambu' = n. bamboo
barbara' ma'rIch = n. Barbara March
balgharya' = n. Bulgaria
bama Hol = n. Burmese language
banan naH = n. banana (Terran fruit)
barat = n. India
baStan = n. Boston
belghIya' = n. Belgium
berlIn = n. Berlin
bewbeb = n. Baobab (a Terran tree)
bIl jo'rIj = n. Bill George
bIQ'a' qIj = n. Black Sea (Terran body of water)
bIqIynIy = n. bikini (Terran clothing)
bIraSIw = n. Brazil
bIrI'tIS qolambIya = n. British Columbia
boSporoS = n. Bosporus
burrI'to = n. burrito (Terran food)
chertIS Su'ghar Sawqe' = n. mint candy, candy mint (Terran peppermint)
cheSqa' = n. Czech Republic
chIrnagho'ra = n. Montenegro
chI'lIy = n. chili (Terran food)
choSan = n. Korea
Da'lar = n. dollar
Denmargh = n. Denmark
DIreS'en = n. Dresden
DItroy' = n. Detroit
DoyIchlan = n. Germany
DoyIchlan Hol = n. German (language)
DujtlhuQ bIQDep = n. starfish (Terran)
gharlIq 'oQqar = n. garlic
ghatlhchu'ghach = n. Monopoly (board game)
ghenlan = n. Greenland
ghIrep naH = n. grape
ghI'neS = n. Guinness
ghI'van = n. gryphon
gho'lIv = n. golf (Terran game)
ghuwan = n. Rouen
ghuwongDung Hol = n. Cantonese language
ghuwI'nItlh wa'lIS = n. Gwynyth Walsh
Hamburgh = n. Hamburg
Hanghuq = n. Korea
HelSIngqIy = n. Helsinki
HInDIy Hol = n. Hindi language
jan qalI'qoS = n. John Colicos
jeghwar = n. jaguar (Terran animal)
jeS QoQ = n. jazz (music)
jeS = n. {jeS QoQ:n}
jIn yopwaH = n. jeans (Terran clothing)
jorja = n. Georgia (US state)
jungwoq = n. China
ju'pIter = n. Jupiter
lanDan = n. London
laS veghaS = n. Las Vegas
layyan = n. lion (Terran animal)
la'pIy = n. Lapland
la'avghe = n. Le Havre
letSeburgh = n. Luxembourg
lIHtentay' = n. Liechtenstein
lIbya' = n. Libya
lIyetu'va' = n. Lithuania
lIyenIn = n. Lenin
lI'lIy = n. lily
maDyar = n. Hungary
maghrIb = n. Morocco
maleSya' = n. Malaysia
malta = n. Malta
mangtay = n. Thailand
maqIy = n. Maquis (Resistance)
marIS = n. Mars
maSmelo' Su'ghar Sawqe' = n. marshmallow (Terran candy)
maSquwa' = n. Moscow
maSIr = n. Egypt
maw = n. Mao
mayqel Do'rIn = n. Michael Dorn
mayqel 'anSara' = n. Michael Ansara
menggho' naH = n. mango
meyIS tIr = n. sweet corn (Terran grain)
mIyama = n. Burma/Myanmar
mongghol 'uluS = n. Mongolia
mu'neqo = n. Monaco
nayeghra = n. Niagara
nayjerya' = n. Nigeria
na'choS = n. nachos (Terran food)
nIve'Da' = n. Nevada
nIylo roDIS = n. Nilo Rodis
noghmanDIy = n. Normandy
norten'erlen = n. Northern Ireland
nuyorgh = n. New York
nu'SIylan = n. New Zealand
panDa' = n. panda bear (Terran animal)
parIy = n. Paris
paSta' = n. pasta, noodles, spaghetti
patat 'oQqar = n. potato (Terran vegetable)
pa'raghway = n. Paraguay
penSIlvenya' = n. Pennsylvania
per naH = n. pear
pe'ru' = n. Peru
pIlam naH = n. plum
pIlIpIynaS = n. the Philippines
pIra'Ha = n. Prague
pItSa' chab = n. pizza
pItlhbergh = n. Pittsburgh
portughal = n. Portugal
po'lISqa' = n. Poland
po'lo yIvbeH = n. polo shirt (Terran clothing)
qalIvornIya = n. California
qamerun = n. Cameroon
qaSaQtan = n. Kazakhstan
qa'mel = n. camel
qa'nabIS = n. cannabis
qa'naDa' = n. Canada
qa'ramel Su'ghar Sawqe' = n. caramel (Terran candy)
qebeq = n. Quebec
qebeq veng = n. Quebec City
qenSaS = n. Kansas
qenya' = n. Kenya
qenggharu' = n. kangaroo (Terran animal)
qe'rot 'oQqar = n. carrot (Terran vegetable)
qo'qa' qo'la' = n. Coca Cola
qoro'na javtIm = n. coronavirus
qoSo'va = n. Kosovo
qo'qo = n. coconut
qo'vID wa'maH Hut = n. {qoro'na javtIm:n}
quba' = n. Cuba
QISmaS = n. Christmas
rabe'rIt 'o'raylIy = n. Robert O'Reilly
raqSan bIQ-DawSon = n. Roxann Biggs-Dawson
raSber naH = n. raspberry
raSya' = n. Russia
ray' tIr = n. rice (Terran grain)
ra'yIn = n. Rhine
romanI'ya' = n. Romania
roma' = n. Rome
ro'Sa' = n. rose (a Terran flower)
SaHa'ra' = n. Sahara (Earth desert)
Sam = n. shawm
SaQatvelo' = n. Georgia
Sarbruqen = n. Saarbrcken (Germany)
Saturn = n. Saturn
Sen = n. Seine
SIlovenISqa' = n. Slovakia
SIqenDInavya' = n. Scandinavia
SIqotlan = n. Scotland
Sol = n. Sun (scientific name for Earth's sun)
Surya' = n. Syria
Sutra'ber naH = n. strawberry
SurIna'ma = n. Suriname
Suverya' = n. Sweden
SuwISya' = n. Switzerland
SuwomIy = n. Finland
Su'ghar qut = n. sugar
Su'ghar Sawqe' = n. sugar clump, piece of candy
Su'ghar SIrghmey = n. cotton candy (Terran confection)
tampere = n. Tampere
tanje'rIn = n. tangerine
taygher = n. tiger (Terran animal)
ta'qo = n. taco (Terran food)
teqSaS = n. Texas
tera' rop bIr = n. common cold (mistranslation)
toba'qo = n. tobacco
tomat naH = n. tomato
toranto = n. Toronto
to'qIpo'na Hol = n. Toki Pona (language)
tu'lIp = n. tulip (Terran flower)
turIqya' = n. Turkey
tlhagh patat 'oQqar naQHom = n. fry, French fry (Terran food)
vanI'la' = n. vanilla
veneSwe'la' = n. Venezuela
vIlaDelvIya' = n. Philadelphia
vIraS = n. France
vIyetnam = n. Vietnam
wa'SIngtanDIySIy = n. Washington, DC
we'lIS = n. Wales
yeru'Sala'yIm = n. Jerusalem
yISra'el = n. Israel
yo'gha' = n. yoga (Terran term)
'amerI'qa' SepjIjQa' = n. United States of America
'amerI'qa' tIng chan tIng = n. South America
'amerI'qa' 'ev chan 'ev = n. North America
'anDo'ra' = n. Andorra
'antartIq = n. Antarctica
'arab Hol = n. Arabic language
'arHentInya' = n. Argentina
'aS = n. Oz
'aSralya' = n. Australia
'aSya' = n. Asia
'aSerbayjan = n. Azerbaijan
'atlantIq bIQ'a' = n. Atlantic Ocean
'avghanIStan = n. Afghanistan
'avrI'qa' = n. Africa
'ayItI = n. Haiti
'a'leghen'I' = n. Allegheny
'elaDya' = n. Greece
'epIl naH = n. apple
'eqwaDor = n. Ecuador
'eSpanya' = n. Spain
'eSperanto Hol = n. Esperanto (language)
'eSpeD = n. spade (card suit)
'eStIy = n. Estonia
'ewro = n. Euro
'ewrop = n. Europe
'eyawaDIy = n. Irrawaddy
'eyre' = n. Ireland
'e'levan = n. elephant
'InDIye'na' = n. Indiana
'InDIyene'palIS = n. Indianapolis
'InuwIt Hol = n. Inuit language
'Inglan = n. England
'ISlan = n. Iceland
'Italya' = n. Italy
'I'ran = n. Iran
'olan 'ambaymey = n. land Islands
'onteryo = n. Ontario
'oSteray' = n. Austria
'oStIn = n. Austin
'uqrayI'na = n. Ukraine
bernarDo = n. Bernardo
ghertlhuD = n. Gertrude
ghIlDeSten = n. Guildenstern
ghorqon = n. Gorkon (legendary)
Hamlet = n. Hamlet
Horey'So = n. Horatio
layerteS = n. Laertes
marSe'luS = n. Marcellus
polonyuS = n. Polonius
qaySar = n. {yulyuS qaySar:n:name}
qornelyuS = n. Cornelius
reynalDo = n. Reynaldo
roSenQatlh = n. Rosencrantz
SeQpIr = n. {wIlyam SeQpIr:n:name}
tlhaw'DIyuS = n. Claudius
veranchISqo = n. Francisco
voltImaD = n. Voltimand
vortIbraS = n. Fortinbras
wIlyam SeQpIr = n. Wil'yam Shex'pir
yulyuS qaySar = n. Yulyush Kayshar
'oSrIq = n. Osric
'ovelya = n. Ophelia
be'joy' = n. a form of ritualistic torture
bIroqlIy majaj = n. broccoli (Terran vegetable)
bIHnuch = n. coward
bolmaq = n. type of animal (makes bleating sounds and tends to run around in circles)
boQwI' = n. assistant (this program)
boqor = n. Bokor
buran = n. Buran (name of Federation ship)
chalqut ngat = n. copper sulfate
chem = n. field? (physics concept)
choH'a' = n. species reassignment protocol
Daq = n. psychic ability?
De'vID = n. De'vID
DIj = n. court, trial?
Do' = n. ship, vessel
ghep = n. age?
ghIlo'meH = n. glo'meH, glommer, type of animal
ghInaq = n. grinnak (a gambling game)
ghIntaq = n. gin'tak, trusted adviser of a Klingon House
ghonglIq = n. gonklik, a kind of vegetable
ghor = n. drive? (mechanical system)
ghurlaq = n. Gurlak
Habnagh = n. type of stone
HurqIq = n. hurkik, a kind of fruit
jep = n. mid-, middle?
jon = n. engineering?
loDmach = n. penis
logh ghotI''a' = n. space whale
lurveng = n. Lurveng
maqtagh = n. Maktag, name of a month or season?
may'qochvan = n. temporary truce (old concept)
meyvaQ = n. some kind of device?
mInHor = n. type of animal, minn'hor (ox-like carnivorous beast of burden, whose milk is used to make cheese)
moratlh ro' = n. Morath's Fist (type of torpedo)
nal = n. mate?
notqa' pach = n. Eagle's Claw (type of ordnance which can be used as torpedo or mine)
pach peng = n. Talon's Strike (standard torpedo type on {toQDuj:n})
pa'mey = n. quarters, living quarters
pel = n. physical exercise?
pev = n. triticale?
pIv = n. warp power?
pojwI' = n. croupier (person in charge of {tISang:n})
puj = n. lithium? mineral?
qoleq = n. {qo'leq:n:name}
qorghlaH = n. Korglach
qulSo' = n. {jamtlhach:n}
qu'vatlh = n. type of animal noted for stubbornness
Qa' = n. union, federation, organization, association, league
QInHom = n. comment
Qov = n. Robyn Stewart
Quvar = n. Quvar
Quv'eq = n. type of animal, kuvrek
raptor = n. {qISa'ruj:n}
rISwI' = n. transponder
rI' = n. modern concept of measurement unit?
roH = n. sign, indication?
roS = v. be agile, be nimble, be spry?
rotarran = n. Rotarran
ro'qegh = n. rokeg, type of animal?
SeH = n. control
SIS = n. rain?
Soq = v. {Suq:v}
SoSbor = n. motherboard, core?
tal = n. map line?
taqnar = n. type of animal, taknar (gizzards used as food; droppings are particularly foul-smelling)
tIb = v. {bIt:v}
tIq'ghob = n. Heart of Virtue
tISang = n. t'Sang (board game)
torghotlh = n. type of animal, torgot (large animal native to {rura' pente':n})
tuQloS = n. a kind of vitamin pill
turghal = n. Turgal
tlhIngan wo' Daq'a' bo'elpu'! = You have entered the jurisdiction of the Klingon Empire.
vIHtaHbogh gho = n. loop (programming)
'aDanjI' = n. adanji, a kind of incense
'eD = v. be landed? be in the air? (aircraft)
'ej = n. star?
'elvIS = n. Elvis
'ISletlh = n. brotherhood? order?
'ISqu' = n. Agnieszka Solska
SIchIyparIy = n. Albania
'aljayIr = n. Algeria
'anggho'la = n. Angola
HayaStan = n. Armenia
DabaHa'maS = n. Bahamas
'elbaHren = n. Bahrain
banglaDeS = n. Bangladesh
babey'DaS = n. Barbados
'ewSIqaDIy = n. Basque Country
bIyelaruS = n. Belarus
beynen = n. Benin
berImyu'Da = n. Bermuda
boSna = n. {boSnayHercheghovIna:n}
boSnayHercheghovIna = n. Bosnia and Herzegovina
buchwa'na = n. Botswana
bIre'tanya = n. Brittany
burqIyna'vaSo = n. Burkina Faso
qampuchIya' = n. Cambodia
qatalunya' = n. Catalonia
be'avrI'qa' = n. Central African Republic
chaD = n. Chad
chI'le = n. Chile
qomorIy = n. Comoros
qonggho = n. Congo
qoStarI'qa = n. Costa Rica
qotDIvwar = n. Cote d'Ivoire
Hervachqa = n. Croatia
qIproS = n. Cyprus
jIbutIy = n. Djibouti
republIyqaDomInIqa'na = n. Dominican Republic
ghIney'eqwatoryal = n. Equatorial Guinea
'erItraya' = n. Eritrea
'Ityop'Iya = n. Ethiopia
vI'chI = n. Fiji
ghabon = n. Gabon
DaghambIya' = n. Gambia
gha'na = n. Ghana
ghene'Da = n. Grenada
ghuwatema'la = n. Guatemala
ghI'nI = n. Guinea
ghInebISaw = n. Guinea-Bissau
ghu'jarat = n. Gujarat
'onDu'raS = n. Honduras
'InDoneSya' = n. Indonesia
'al'ay'raq = n. Iraq
'IStanbul = n. Istanbul
jame'qa = n. Jamaica
'al'urDun = n. Jordan
qIrIbaS = n. Kiribati
qurDIStan = n. Kurdistan
'elquwet = n. Kuwait
latvIya = n. Latvia
lIbnen = n. Lebanon
leSu'tu = n. Lesotho
laybIrya' = n. Liberia
Se'vernamaqeDonya' = n. North Macedonia
maDaghaSqIyar = n. Madagascar
mala'wIy = n. Malawi
ma'lIy = n. Mali
murItanya' = n. Mauritania
morIS = n. Mauritius
me'HIyqo = n. Mexico
molDo'va = n. Moldova
moSambIyqI = n. Mozambique
namIbya' = n. Namibia
nIyjer = n. Niger
'oSIya'nIya = n. Oceania
'uman = n. Oman
paqIStan = n. Pakistan
vIlaStIn = n. Palestine
panama' = n. Panama
papwanughI'nIy = n. Papua New Guinea
ruwanDa = n. Rwanda
Sammowa = n. Samoa
SammarI'no = n. San Marino
'al'arabyatSawDI'ya = n. Saudi Arabia
Seneghal = n. Senegal
SIrbIya' = n. Serbia
SIye'ralIyon = n. Sierra Leone
SIngapor = n. Singapore
SIlove'nIya = n. Slovenia
Soma'lIya = n. Somalia
SawtavrI'qa' = n. South Africa
SIrIylangqa = n. Sri Lanka
SuDan = n. Sudan
'eSwat'I'nI = n. Swaziland
tanSanI'ya = n. Tanzania
po = n. Tibet
togho = n. Togo
to'nga = n. Tonga
tIrI'nIDaD tabey'gho je = n. Trinidad and Tobago
tu'nIS = n. Tunisia
tuva'lu = n. Tuvalu
'ughanDa = n. Uganda
'al'Imarat = n. United Arab Emirates
'urughway' = n. Uruguay
vanuwa'tu = n. Vanuatu
vatIqan veng = n. Vatican
'alya'man = n. Yemen
SambIya = n. Zambia
SImbabwe = n. Zimbabwe
'avrIHI'lI' Hol = n. Afrihili
'avrIqaS Hol = n. Afrikaans
bIlIS ngutlhmey = n. Blissymbols
Dotra'qIy Hol = n. Dothraki
HawSa Hol = n. Hausa
'IyDo Hol = n. Ido
'Ighbo Hol = n. Igbo
'InterlIngwa' Hol = n. Interlingua
la'Dan Hol = n. Ladan
latIyna Hol = n. Latin
lIngwavIrangqano'va Hol = n. Lingua Franca Nova
lIngwa'Ighno'ta Hol = n. Lingua Ignota
lIngwaDepIlane'ta Hol = n. Lingwa de Planeta
lojban Hol = n. Lojban
mentIy Hol = n. Mnti
na'vIy Hol = n. Na'vi
neyo Hol = n. Neo
quwenya' Hol = n. Quenya
SambaSa Hol = n. Sambahsa
qa'lIq Hol = n. Scottish Gaelic
SemI'tIS Hol = n. Semitish
SInDarIn Hol = n. Sindarin
SolreySol Hol = n. Solresol
So'mIS Hol = n. Somish
toqpISIn Hol = n. Tok Pisin
tIro'ma Hol = n. Traumae
cheS Hol = n. Tsez
'unqer ghItlhmeH Ho'DoS quq = n. Unker Non-Linear Writing System
volapuq Hol = n. Volapk
yoruba' Hol = n. Yoruba
bIghung'a'? = Are you hungry?
bI'oj'a'? = Are you thirsty?
choquvmoH. = You honor me.
choyaj'a'? = Do you understand me?
Holmey Dajatlhbogh tIngu'! = Which languages do you speak?
lenglIj DatIv'a'? = Did you enjoy your trip?
nuqDaq 'oH juHlIj'e'? = Where do you live? Where is your home?
nuq 'oH ponglIj'e'? = What is your name?
qaqIHmo' jIquv. = I am honored to meet you.
qaStaH nuq? = What's happening? What's up?
qavan! = I salute you!
QIt yIjatlh! = Speak slowly!
Savan! = I salute you, I salute you all!
taghbej mu'qaD veS. = Curse-warfare has definitely begun.
taghjaj Qujmey! = Let the games begin!
tuquvmoH. = You honor me, you all honor me.
tlhIngan Hol vIghoj. = I learn Klingon.
yIghItlh. = Write it down.
beQmoH = v. flatten
bIrmoH = v. chill, cool (something) down
HoSmoH = v. strengthen
machmoH = v. shrink (something)
rItHa' = v. dismiss, unsummon
SovmoH = v. inform
tInmoH = v. enlarge
tujmoH = v. heat (something) up
cho'tay = n. Rite of Succession
DIp DelwI' = n. adjective
Do juvwI' = n. speedometer
Do QIn = n. instant message
Hung buv rav = n. minimum security classification
leng chach mab = n. voyage cancellation insurance
maH DIS poH = n. decade
mIv'a' javtIm = n. {qoro'na javtIm:n}
muHwI' = n. executioner
nen rav = n. minimum age
neqjung wa'DIch = n. first contact
ngongmeH Duj = n. experimental ship
puq poH veb = n. The Next Generation
qogh qorghwI' = n. earplug
qoqyoq = n. android
QongmeH Duj = n. sleeper ship
wot DelwI' = n. adverb (not in Klingon)
yachwI' = n. brush
yaD pach = n. toenail
'Iv juvwI' = n. altimeter
jagh 'Iw vIpoQ. = I demand the blood of the enemy.
may'wIj 'oH may'vam'e'. = This battle is my battle.
qamDu'wIjDaq Heghpu'bogh jagh tu'lu'. = The body of the dead enemy lies in front of my feet.
taHjaj wo' = An Imperial Anthem
yIH bom = The Tribble Song
beq may' ta vIlajpu'. = I have accepted the crew's record of battle.
bIghHa' DamejDI' pagh QaS yInob. = Get out of jail free.
bIQong'eghqangchoHmoHlaHchu'pu'neSchugh = v. meaningless verbal phrase
bI'IHqu'. = You're very beautiful.
chuvmey tI'uch. = Keep the change.
DaH yaS wa'DIch vIgheS. = I now take my place as first officer.
Daq DaDabbogh yIngu'! = Where do you live?
ghomHa'! = Dismissed!
ghopDu'wIjDaq yInmeyraj vIlaj. = I accept your lives into my hands.
jar DamaSqu'bogh yIngu'! = What is your favorite month?
juDev 'ej Dujvam ra'wI' DagheS 'e' vItlhob. = I ask you to lead us as commander of this ship.
jISuDrup. = I'm feeling lucky.
loSmaH ben jIboghpu'. = I am 40 years old.
lupDujHomwIj lubuy'moH gharghmey. = My hovercraft is full of eels.
nIn Hoch natlhlu'pu'. = All the fuel has been consumed.
nuH DaneHbogh yIngu'! = Which weapon do you want?
nuQaw'qu'be'. = They have not finished us off.
paghlogh jegh tlhIngan SuvwI'. = A Klingon warrior never surrenders.
qamuSHa'. = I love you.
qoSlIj DatIvjaj! = Happy birthday!
QaghHommeyHeylIjmo' = n. due to your apparent minor errors
wa'maH ben loDnI'wI' = n. my 10-year-old brother
yIDoghQo'! = Don't be silly!
